pedestrians,towards_manhattan,towards_brooklyn,date,weather,events
3,3,0,2019-04-30,nan,nan
10,9,1,2019-12-31,cloudy,nan
2,0,2,2019-12-31,cloudy,nan
12,0,12,2019-12-31,cloudy,nan
1,0,1,2019-04-01,clear-night,nan
3171,1685,1486,2019-12-25,clear-day,Christmas Day
13,5,8,2019-01-27,partly-cloudy-night,nan
0,0,0,2019-02-07,cloudy,nan
9,7,2,2019-01-03,partly-cloudy-night,nan
520,281,239,2019-08-13,partly-cloudy-day,nan
2,1,1,2019-08-31,clear-night,nan
125,66,59,2019-11-04,clear-night,nan
2627,1142,1485,2019-08-24,partly-cloudy-day,nan
1601,730,871,2019-04-02,partly-cloudy-day,nan
22,21,1,2019-12-02,cloudy,nan
36,15,21,2019-05-06,cloudy,nan
2708,1447,1261,2019-12-22,clear-day,nan
2270,1020,1250,2019-08-15,partly-cloudy-day,nan
3,1,2,2019-02-25,partly-cloudy-night,nan
1151,666,485,2019-03-11,clear-day,nan
1557,707,850,2019-08-18,partly-cloudy-day,nan
79,65,14,2019-08-25,partly-cloudy-night,nan
0,0,0,2019-02-13,cloudy,nan
1805,754,1051,2019-04-28,cloudy,nan
442,188,254,2019-11-01,clear-day,nan
2826,1425,1401,2019-04-20,cloudy,nan
1554,637,917,2019-09-11,partly-cloudy-day,nan
610,386,224,2019-06-11,partly-cloudy-day,nan
1773,894,879,2019-06-24,partly-cloudy-day,nan
0,0,0,2019-03-08,clear-night,nan
0,0,0,2019-12-26,partly-cloudy-night,nan
1532,726,806,2019-03-04,partly-cloudy-day,nan
4,2,2,2019-06-25,partly-cloudy-night,nan
0,0,0,2019-04-13,cloudy,nan
1120,449,671,2019-02-03,partly-cloudy-day,nan
0,0,0,2019-11-04,clear-night,nan
8,4,4,2019-07-10,clear-night,nan
1080,463,617,2019-11-20,partly-cloudy-day,nan
186,83,103,2019-07-05,cloudy,nan
0,0,0,2019-06-15,clear-night,nan
199,70,129,2019-03-20,clear-night,nan
23,14,9,2019-08-14,partly-cloudy-night,nan
741,409,332,2019-02-25,clear-day,nan
1394,609,785,2019-03-13,clear-day,nan
58,36,22,2019-03-29,partly-cloudy-night,nan
41,38,3,2019-10-12,partly-cloudy-night,nan
27,16,11,2019-08-16,partly-cloudy-night,nan
482,197,285,2019-06-14,clear-day,nan
21,19,2,2019-02-28,clear-night,nan
1275,722,553,2019-11-06,clear-day,nan
2023,868,1155,2019-08-12,partly-cloudy-day,nan
0,0,0,2019-09-24,partly-cloudy-night,nan
0,0,0,2019-01-27,clear-night,nan
3,0,3,2019-12-08,clear-night,nan
1473,823,650,2019-06-11,clear-day,nan
0,0,0,2019-08-02,partly-cloudy-night,nan
20,14,6,2019-09-24,partly-cloudy-night,nan
1773,936,837,2019-08-20,partly-cloudy-day,nan
38,27,11,2019-10-18,partly-cloudy-night,nan
126,75,51,2019-04-19,partly-cloudy-night,nan
1757,771,986,2019-06-20,cloudy,nan
56,48,8,2019-09-14,cloudy,nan
160,81,79,2019-02-12,fog,nan
1329,619,710,2019-09-04,partly-cloudy-day,nan
1,0,1,2019-03-03,partly-cloudy-night,nan
13,11,2,2019-10-31,cloudy,Halloween
12,0,12,2019-12-16,rain,nan
4,1,3,2019-01-16,clear-night,nan
2,0,2,2019-08-01,clear-night,nan
535,219,316,2019-04-25,clear-day,nan
0,0,0,2019-02-27,cloudy,nan
1779,810,969,2019-07-21,partly-cloudy-day,nan
77,62,15,2019-01-06,partly-cloudy-night,nan
65,50,15,2019-10-05,partly-cloudy-night,nan
592,217,375,2019-09-22,partly-cloudy-night,nan
568,262,306,2019-05-01,cloudy,nan
1,0,1,2019-03-17,clear-night,St. Patrick's Day
1286,1286,0,2019-02-19,clear-day,nan
1439,622,817,2019-02-18,partly-cloudy-day,Presidents' Day (regional holiday)
3514,1854,1660,2019-04-06,clear-day,nan
0,0,0,2019-04-07,clear-night,nan
71,62,9,2019-11-25,clear-night,nan
1642,900,742,2019-07-10,partly-cloudy-day,nan
29,20,9,2019-05-08,cloudy,nan
139,66,73,2019-06-20,rain,nan
1683,981,702,2019-07-05,cloudy,nan
686,353,333,2019-05-20,partly-cloudy-day,nan
668,305,363,2019-02-01,partly-cloudy-day,nan
66,29,37,2019-06-16,partly-cloudy-night,nan
0,0,0,2019-09-02,partly-cloudy-night,Labor Day
8,3,5,2019-07-06,cloudy,nan
1641,749,892,2019-04-08,partly-cloudy-day,nan
0,0,0,2019-01-05,rain,nan
311,108,203,2019-04-08,cloudy,nan
665,273,392,2019-05-06,partly-cloudy-day,nan
5,0,5,2019-03-29,cloudy,nan
11,4,7,2019-07-21,partly-cloudy-night,nan
0,0,0,2019-08-22,partly-cloudy-night,nan
1189,439,750,2019-03-30,clear-day,nan
1694,847,847,2019-03-02,rain,nan
0,0,0,2019-11-24,rain,nan
2152,975,1177,2019-07-24,partly-cloudy-day,nan
1597,753,844,2019-03-26,clear-day,nan
5,3,2,2019-08-03,clear-night,nan
70,65,5,2019-12-06,cloudy,nan
0,0,0,2019-11-29,clear-night,Black Friday
0,0,0,2019-09-30,partly-cloudy-night,nan
132,48,84,2019-11-12,rain,nan
1895,889,1006,2019-09-03,partly-cloudy-day,nan
36,25,11,2019-03-10,partly-cloudy-night,Daylight Saving Time starts
1916,908,1008,2019-09-17,clear-day,nan
703,371,332,2019-04-26,cloudy,nan
180,92,88,2019-12-12,clear-night,nan
1000,524,476,2019-11-17,partly-cloudy-day,nan
284,106,178,2019-03-28,clear-day,nan
0,0,0,2019-08-08,partly-cloudy-night,nan
1299,583,716,2019-06-27,partly-cloudy-day,nan
2,1,1,2019-08-11,clear-night,nan
30,29,1,2019-12-27,clear-night,nan
260,102,158,2019-12-04,cloudy,nan
2352,1031,1321,2019-10-18,partly-cloudy-day,nan
2387,1005,1382,2019-06-02,partly-cloudy-day,nan
0,0,0,2019-11-07,partly-cloudy-night,nan
139,48,91,2019-06-19,cloudy,nan
1833,840,993,2019-03-15,partly-cloudy-day,nan
1954,890,1064,2019-05-22,clear-day,nan
0,0,0,2019-03-25,cloudy,nan
137,55,82,2019-04-05,partly-cloudy-day,nan
2056,887,1169,2019-09-30,cloudy,nan
1323,733,590,2019-06-13,cloudy,nan
2337,1043,1294,2019-06-23,clear-day,nan
8,4,4,2019-01-20,partly-cloudy-night,nan
0,0,0,2019-07-24,cloudy,nan
150,70,80,2019-06-08,clear-day,nan
0,0,0,2019-03-06,partly-cloudy-night,nan
2239,1073,1166,2019-10-07,partly-cloudy-day,nan
1,0,1,2019-02-16,partly-cloudy-night,nan
522,292,230,2019-01-15,clear-day,nan
1044,598,446,2019-06-02,partly-cloudy-day,nan
3,1,2,2019-07-17,partly-cloudy-night,nan
1877,885,992,2019-06-17,cloudy,nan
2,0,2,2019-03-14,partly-cloudy-night,nan
11,6,5,2019-09-05,partly-cloudy-night,nan
0,0,0,2019-10-05,clear-night,nan
1,0,1,2019-05-24,clear-night,nan
7,0,7,2019-05-12,cloudy,nan
1,0,1,2019-11-27,clear-night,nan
2,1,1,2019-12-05,partly-cloudy-night,nan
30,23,7,2019-12-21,partly-cloudy-night,nan
1600,702,898,2019-04-11,cloudy,nan
261,157,104,2019-04-30,partly-cloudy-night,nan
1958,856,1102,2019-02-21,rain,nan
2358,1006,1352,2019-11-16,clear-day,nan
69,42,27,2019-02-05,partly-cloudy-night,nan
3116,1370,1746,2019-08-10,partly-cloudy-day,nan
608,264,344,2019-09-19,clear-night,nan
263,120,143,2019-06-24,clear-day,nan
78,76,2,2019-02-07,cloudy,nan
1926,897,1029,2019-05-02,partly-cloudy-day,nan
1511,848,663,2019-06-28,partly-cloudy-day,nan
396,237,159,2019-12-14,partly-cloudy-day,nan
32,11,21,2019-05-25,partly-cloudy-night,nan
1,0,1,2019-06-04,clear-night,nan
5,4,1,2019-01-14,clear-night,nan
1,0,1,2019-01-27,clear-night,nan
2296,945,1351,2019-06-15,partly-cloudy-day,nan
3,0,3,2019-02-12,rain,nan
257,123,134,2019-01-11,clear-day,nan
1,0,1,2019-11-16,clear-night,nan
61,60,1,2019-10-23,clear-night,nan
1589,663,926,2019-08-13,rain,nan
59,54,5,2019-09-19,clear-night,nan
1,0,1,2019-12-12,clear-night,nan
3524,1647,1877,2019-04-13,clear-day,nan
3,2,1,2019-11-21,partly-cloudy-night,nan
1481,676,805,2019-05-22,clear-day,nan
900,524,376,2019-12-21,partly-cloudy-day,nan
0,0,0,2019-03-21,cloudy,nan
1,0,1,2019-02-07,cloudy,nan
1632,739,893,2019-03-18,cloudy,nan
28,12,16,2019-05-30,cloudy,nan
3335,1431,1904,2019-10-13,partly-cloudy-day,nan
0,0,0,2019-07-22,partly-cloudy-night,nan
2353,1099,1254,2019-10-25,partly-cloudy-day,nan
15,14,1,2019-02-24,partly-cloudy-night,nan
1,0,1,2019-06-10,cloudy,nan
2818,1218,1600,2019-06-09,partly-cloudy-day,nan
9,1,8,2019-09-25,clear-night,nan
1,0,1,2019-04-27,rain,nan
3157,1394,1763,2019-08-24,partly-cloudy-day,nan
2521,1174,1347,2019-08-25,partly-cloudy-day,nan
2,1,1,2019-04-19,partly-cloudy-night,nan
0,0,0,2019-09-21,clear-night,nan
959,416,543,2019-01-22,clear-day,nan
8,0,8,2019-11-29,clear-night,nan
1,0,1,2019-03-19,partly-cloudy-night,nan
0,0,0,2019-04-15,partly-cloudy-night,Tax Day
368,217,151,2019-09-29,partly-cloudy-day,nan
1,0,1,2019-04-12,cloudy,nan
311,196,115,2019-04-14,partly-cloudy-day,nan
881,548,333,2019-06-15,partly-cloudy-day,nan
354,138,216,2019-12-01,sleet,nan
0,0,0,2019-02-15,clear-night,nan
0,0,0,2019-02-10,clear-night,nan
2928,1354,1574,2019-03-24,clear-day,nan
663,374,289,2019-01-20,rain,nan
269,142,127,2019-12-11,snow,nan
2745,1181,1564,2019-04-17,clear-day,nan
43,17,26,2019-08-05,clear-night,nan
1,0,1,2019-09-13,cloudy,nan
2513,1256,1257,2019-05-24,partly-cloudy-day,nan
0,0,0,2019-09-15,partly-cloudy-night,nan
279,136,143,2019-06-17,partly-cloudy-day,nan
1,0,1,2019-09-11,clear-night,nan
0,0,0,2019-10-12,cloudy,nan
105,97,8,2019-01-10,clear-night,nan
2,0,2,2019-04-17,cloudy,nan
1354,540,814,2019-09-26,cloudy,nan
4,4,0,2019-09-07,partly-cloudy-night,nan
1973,1087,886,2019-08-29,clear-day,nan
0,0,0,2019-02-09,clear-night,nan
1,0,1,2019-10-01,cloudy,nan
144,24,120,2019-01-01,rain,New Year's Day
1395,708,687,2019-06-13,cloudy,nan
0,0,0,2019-10-13,clear-night,nan
2,1,1,2019-10-19,clear-night,nan
703,251,452,2019-10-22,cloudy,nan
1,0,1,2019-12-27,cloudy,nan
0,0,0,2019-02-19,clear-night,nan
1084,388,696,2019-10-06,cloudy,nan
1885,1062,823,2019-09-09,partly-cloudy-day,nan
255,145,110,2019-12-17,rain,nan
0,0,0,2019-04-08,rain,nan
0,0,0,2019-07-15,clear-night,nan
19,8,11,2019-08-27,partly-cloudy-night,nan
5,3,2,2019-12-26,cloudy,nan
55,53,2,2019-09-18,clear-night,nan
1,0,1,2019-12-20,partly-cloudy-night,nan
0,0,0,2019-02-02,clear-day,nan
1842,796,1046,2019-05-29,cloudy,nan
0,0,0,2019-01-24,cloudy,nan
1590,674,916,2019-07-29,partly-cloudy-day,nan
1900,818,1082,2019-10-01,partly-cloudy-day,nan
13,7,6,2019-07-17,clear-night,nan
786,413,373,2019-10-17,partly-cloudy-day,nan
798,341,457,2019-10-31,rain,Halloween
124,119,5,2019-01-28,clear-night,nan
9,4,5,2019-07-23,rain,nan
6,5,1,2019-12-31,partly-cloudy-night,New Year's Eve
1563,679,884,2019-03-17,clear-day,St. Patrick's Day
0,0,0,2019-11-05,clear-night,nan
2587,1058,1529,2019-09-08,partly-cloudy-day,nan
15,15,0,2019-02-23,cloudy,nan
8,5,3,2019-09-29,clear-night,nan
2341,1231,1110,2019-03-23,clear-day,nan
1570,736,834,2019-08-21,partly-cloudy-day,nan
29,25,4,2019-03-23,partly-cloudy-night,nan
28,22,6,2019-07-28,clear-night,nan
1990,1033,957,2019-08-02,partly-cloudy-day,nan
1456,690,766,2019-09-23,clear-day,nan
2111,910,1201,2019-01-04,clear-day,nan
1321,479,842,2019-12-03,partly-cloudy-day,nan
116,81,35,2019-11-26,clear-night,nan
819,379,440,2019-03-06,partly-cloudy-day,nan
14,14,0,2019-04-06,rain,nan
1787,820,967,2019-11-11,clear-day,Veterans Day
128,51,77,2019-03-06,partly-cloudy-night,nan
543,233,310,2019-07-24,partly-cloudy-day,nan
2566,1206,1360,2019-12-08,clear-day,nan
46,32,14,2019-02-16,clear-night,nan
0,0,0,2019-05-13,cloudy,nan
35,29,6,2019-03-12,partly-cloudy-night,nan
2,1,1,2019-01-21,partly-cloudy-night,Martin Luther King Jr. Day
2720,1124,1596,2019-06-23,clear-day,nan
897,420,477,2019-01-15,clear-day,nan
2192,1044,1148,2019-10-11,cloudy,nan
1576,784,792,2019-04-04,clear-day,nan
1220,576,644,2019-04-09,cloudy,nan
186,71,115,2019-03-19,clear-night,nan
499,161,338,2019-06-03,clear-day,nan
17,17,0,2019-02-20,clear-night,nan
571,225,346,2019-08-15,partly-cloudy-night,nan
1598,641,957,2019-03-28,clear-day,nan
1057,577,480,2019-06-18,cloudy,nan
158,79,79,2019-05-28,clear-day,nan
56,48,8,2019-09-13,partly-cloudy-night,nan
1832,882,950,2019-07-25,clear-day,nan
949,398,551,2019-11-13,clear-day,nan
185,84,101,2019-08-16,partly-cloudy-night,nan
521,263,258,2019-09-10,cloudy,nan
22,0,22,2019-03-14,clear-night,nan
223,109,114,2019-05-13,rain,nan
17,9,8,2019-01-18,cloudy,nan
1035,451,584,2019-02-10,partly-cloudy-day,nan
2328,1145,1183,2019-11-30,clear-day,nan
3,1,2,2019-01-08,partly-cloudy-night,nan
1657,993,664,2019-09-03,clear-day,nan
35,13,22,2019-09-08,partly-cloudy-night,nan
639,305,334,2019-06-03,clear-day,nan
1225,577,648,2019-10-02,clear-day,nan
449,199,250,2019-10-21,clear-day,nan
33,0,33,2019-10-10,cloudy,nan
172,109,63,2019-12-17,rain,nan
788,387,401,2019-02-20,cloudy,nan
66,40,26,2019-06-16,rain,Father's Day
2286,1060,1226,2019-11-25,partly-cloudy-day,nan
1900,818,1082,2019-09-10,cloudy,nan
1020,611,409,2019-07-16,clear-day,nan
142,126,16,2019-01-22,clear-night,nan
61,29,32,2019-06-18,cloudy,nan
2015,856,1159,2019-11-25,clear-day,nan
24,16,8,2019-02-18,rain,Presidents' Day (regional holiday)
0,0,0,2019-04-07,clear-night,nan
1702,814,888,2019-04-15,partly-cloudy-day,Tax Day
16,10,6,2019-01-25,partly-cloudy-night,nan
25,23,2,2019-05-05,cloudy,Cinco de Mayo
60,55,5,2019-02-01,partly-cloudy-night,nan
447,175,272,2019-07-02,clear-day,nan
0,0,0,2019-10-02,clear-night,nan
1588,647,941,2019-11-08,partly-cloudy-day,nan
3,2,1,2019-05-09,partly-cloudy-night,nan
397,154,243,2019-11-26,clear-day,nan
0,0,0,2019-12-19,clear-night,nan
0,0,0,2019-03-22,rain,nan
2,1,1,2019-02-11,partly-cloudy-night,nan
0,0,0,2019-04-03,cloudy,nan
818,373,445,2019-11-13,clear-day,nan
1215,545,670,2019-12-05,cloudy,nan
0,0,0,2019-03-30,cloudy,nan
5,2,3,2019-11-27,cloudy,Thanksgiving Day
927,568,359,2019-09-15,partly-cloudy-day,nan
2386,1111,1275,2019-05-03,cloudy,nan
1712,729,983,2019-11-27,cloudy,nan
1318,594,724,2019-03-08,clear-day,nan
38,19,19,2019-08-03,partly-cloudy-night,nan
1200,511,689,2019-02-28,clear-day,nan
34,25,9,2019-01-05,cloudy,nan
1461,654,807,2019-03-29,cloudy,nan
2110,1069,1041,2019-08-06,partly-cloudy-day,nan
2,1,1,2019-10-23,cloudy,nan
297,120,177,2019-10-17,cloudy,nan
63,47,16,2019-05-19,partly-cloudy-night,nan
1,0,1,2019-12-02,cloudy,nan
395,194,201,2019-08-04,partly-cloudy-day,nan
0,0,0,2019-06-26,clear-night,nan
2180,959,1221,2019-11-03,partly-cloudy-day,Daylight Saving Time ends
49,29,20,2019-10-16,partly-cloudy-night,nan
0,0,0,2019-11-10,partly-cloudy-night,nan
2354,1133,1221,2019-07-07,partly-cloudy-day,nan
558,306,252,2019-12-30,rain,nan
556,313,243,2019-12-18,clear-day,nan
3001,1416,1585,2019-10-26,partly-cloudy-day,nan
1644,777,867,2019-11-05,clear-day,nan
2913,1336,1577,2019-08-31,partly-cloudy-day,nan
1884,982,902,2019-06-30,partly-cloudy-day,nan
162,82,80,2019-08-27,partly-cloudy-night,nan
519,249,270,2019-01-29,cloudy,nan
177,89,88,2019-01-31,clear-day,nan
723,298,425,2019-06-19,cloudy,nan
82,35,47,2019-02-23,partly-cloudy-night,nan
970,487,483,2019-03-20,clear-day,nan
0,0,0,2019-01-10,partly-cloudy-night,nan
0,0,0,2019-01-12,partly-cloudy-day,nan
0,0,0,2019-10-14,cloudy,Columbus Day (regional holiday)
17,0,17,2019-04-03,clear-night,nan
34,13,21,2019-04-20,rain,nan
2203,897,1306,2019-09-14,cloudy,nan
3031,1391,1640,2019-09-28,partly-cloudy-day,nan
1142,553,589,2019-02-14,clear-day,Valentine's Day
455,242,213,2019-06-10,fog,nan
422,164,258,2019-11-04,clear-day,nan
29,0,29,2019-10-20,clear-night,nan
1664,676,988,2019-06-29,partly-cloudy-day,nan
20,17,3,2019-04-28,clear-night,nan
2042,1011,1031,2019-06-12,clear-day,nan
794,437,357,2019-03-05,clear-day,nan
844,453,391,2019-09-12,partly-cloudy-day,nan
313,128,185,2019-08-26,cloudy,nan
1704,1010,694,2019-06-06,partly-cloudy-day,nan
0,0,0,2019-04-21,partly-cloudy-night,Easter Sunday
3,2,1,2019-10-06,cloudy,nan
0,0,0,2019-07-08,partly-cloudy-night,nan
137,82,55,2019-06-08,clear-night,nan
2,1,1,2019-04-14,cloudy,Tax Day
2385,1175,1210,2019-05-15,partly-cloudy-day,nan
2,0,2,2019-04-10,clear-night,nan
50,48,2,2019-12-03,clear-night,nan
2035,950,1085,2019-08-09,clear-day,nan
12,6,6,2019-10-14,clear-night,Columbus Day (regional holiday)
340,131,209,2019-11-15,clear-day,nan
0,0,0,2019-10-09,partly-cloudy-night,nan
57,40,17,2019-07-31,clear-night,nan
0,0,0,2019-08-24,partly-cloudy-night,nan
1854,983,871,2019-11-28,cloudy,Thanksgiving Day
855,433,422,2019-04-10,clear-day,nan
0,0,0,2019-05-02,fog,nan
1768,1034,734,2019-09-01,partly-cloudy-day,nan
0,0,0,2019-03-27,clear-night,nan
100,84,16,2019-05-28,partly-cloudy-night,nan
291,126,165,2019-09-27,clear-day,nan
6,1,5,2019-03-02,snow,nan
404,244,160,2019-07-28,partly-cloudy-day,nan
40,40,0,2019-12-29,rain,nan
753,391,362,2019-04-26,rain,nan
210,95,115,2019-03-17,clear-day,St. Patrick's Day
2150,797,1353,2019-04-21,partly-cloudy-day,Easter Sunday
214,107,107,2019-05-23,rain,nan
0,0,0,2019-09-17,partly-cloudy-night,nan
68,55,13,2019-05-27,clear-night,Memorial Day
1160,720,440,2019-08-07,partly-cloudy-day,nan
0,0,0,2019-12-17,rain,nan
1260,737,523,2019-03-09,clear-day,nan
1,0,1,2019-10-25,clear-night,nan
81,70,11,2019-10-03,rain,nan
92,23,69,2019-05-17,partly-cloudy-night,nan
281,130,151,2019-09-16,cloudy,nan
12,8,4,2019-10-11,cloudy,nan
1883,983,900,2019-05-21,clear-day,nan
618,333,285,2019-02-11,cloudy,nan
254,99,155,2019-04-16,clear-day,nan
2191,969,1222,2019-05-07,clear-day,nan
8,5,3,2019-07-02,cloudy,nan
202,117,85,2019-05-12,rain,Mother's Day
0,0,0,2019-11-02,clear-night,nan
5,5,0,2019-05-04,rain,nan
46,42,4,2019-04-18,clear-night,nan
0,0,0,2019-09-27,clear-night,nan
2124,1048,1076,2019-08-09,partly-cloudy-day,nan
334,175,159,2019-02-28,clear-day,nan
58,55,3,2019-12-28,clear-night,nan
0,0,0,2019-05-25,clear-night,nan
40,19,21,2019-03-01,snow,nan
10,7,3,2019-01-13,clear-night,nan
1968,842,1126,2019-10-15,clear-day,nan
987,421,566,2019-12-19,clear-day,nan
932,461,471,2019-05-03,cloudy,nan
306,158,148,2019-03-07,clear-day,nan
457,195,262,2019-03-22,partly-cloudy-day,nan
1686,931,755,2019-07-15,clear-day,nan
3,2,1,2019-06-14,clear-night,nan
0,0,0,2019-10-11,partly-cloudy-night,nan
1811,868,943,2019-04-04,clear-day,nan
4,1,3,2019-12-05,partly-cloudy-night,nan
282,127,155,2019-07-20,partly-cloudy-day,nan
12,4,8,2019-09-02,partly-cloudy-night,nan
84,50,34,2019-10-11,clear-night,nan
13,11,2,2019-06-13,partly-cloudy-night,nan
1,0,1,2019-05-10,cloudy,nan
2,1,1,2019-01-31,clear-night,nan
18,17,1,2019-12-29,partly-cloudy-night,nan
1129,490,639,2019-02-14,partly-cloudy-day,Valentine's Day
256,141,115,2019-08-23,rain,nan
8,6,2,2019-11-18,rain,nan
244,103,141,2019-04-22,partly-cloudy-day,Easter Monday
585,296,289,2019-09-26,clear-day,nan
179,60,119,2019-03-06,clear-day,nan
2242,949,1293,2019-04-22,cloudy,Easter Monday
3,2,1,2019-03-25,cloudy,nan
44,31,13,2019-06-12,clear-night,nan
664,415,249,2019-08-30,clear-day,nan
2765,1174,1591,2019-08-04,partly-cloudy-day,nan
893,415,478,2019-12-13,cloudy,nan
2072,996,1076,2019-07-26,partly-cloudy-day,nan
2363,1190,1173,2019-09-21,clear-day,nan
0,0,0,2019-11-03,clear-night,nan
384,167,217,2019-10-10,partly-cloudy-day,nan
3,2,1,2019-01-01,cloudy,New Year's Day
1,0,1,2019-03-14,cloudy,nan
0,0,0,2019-10-30,cloudy,nan
34,23,11,2019-12-18,cloudy,nan
1714,846,868,2019-05-10,partly-cloudy-day,nan
2,1,1,2019-09-22,clear-night,nan
5,2,3,2019-10-27,clear-night,nan
1311,636,675,2019-12-11,partly-cloudy-day,nan
291,119,172,2019-07-16,clear-day,nan
3615,1632,1983,2019-10-12,partly-cloudy-day,nan
320,145,175,2019-07-11,rain,nan
188,108,80,2019-09-07,clear-night,nan
333,166,167,2019-02-06,clear-day,nan
2574,1080,1494,2019-05-06,clear-day,nan
3,3,0,2019-02-20,clear-night,nan
607,279,328,2019-01-19,cloudy,nan
3,3,0,2019-01-06,nan,nan
1708,838,870,2019-03-29,cloudy,nan
389,197,192,2019-12-07,clear-day,nan
1942,889,1053,2019-08-06,partly-cloudy-day,nan
0,0,0,2019-04-06,cloudy,nan
133,64,69,2019-01-11,clear-night,nan
95,42,53,2019-03-08,clear-day,nan
17,14,3,2019-08-25,partly-cloudy-night,nan
2590,1167,1423,2019-11-02,clear-day,nan
1535,858,677,2019-09-25,clear-day,nan
0,0,0,2019-03-30,partly-cloudy-night,nan
23,10,13,2019-08-14,partly-cloudy-night,nan
20,18,2,2019-04-29,clear-night,nan
2336,1193,1143,2019-02-17,clear-day,nan
137,97,40,2019-01-16,partly-cloudy-night,nan
2,1,1,2019-02-22,clear-night,nan
1,0,1,2019-11-24,rain,nan
794,380,414,2019-02-06,cloudy,nan
124,53,71,2019-06-30,clear-day,nan
695,392,303,2019-08-08,partly-cloudy-day,nan
247,131,116,2019-01-19,partly-cloudy-day,nan
132,48,84,2019-01-28,clear-night,nan
1120,393,727,2019-05-26,cloudy,nan
85,41,44,2019-01-22,clear-night,nan
1299,624,675,2019-06-25,cloudy,nan
1,0,1,2019-04-10,clear-night,nan
1,0,1,2019-10-27,cloudy,nan
0,0,0,2019-03-24,clear-night,nan
0,0,0,2019-11-21,clear-night,nan
0,0,0,2019-11-10,partly-cloudy-night,nan
0,0,0,2019-08-26,clear-night,nan
2160,1016,1144,2019-03-16,partly-cloudy-day,nan
167,63,104,2019-07-12,partly-cloudy-day,nan
1764,978,786,2019-05-22,clear-day,nan
14,3,11,2019-04-29,cloudy,nan
12,6,6,2019-03-05,partly-cloudy-night,nan
37,20,17,2019-08-07,partly-cloudy-night,nan
103,102,1,2019-12-23,clear-night,nan
1552,710,842,2019-01-26,partly-cloudy-day,nan
1203,495,708,2019-03-12,partly-cloudy-day,nan
2397,1147,1250,2019-07-12,partly-cloudy-day,nan
2268,1125,1143,2019-07-03,partly-cloudy-day,nan
341,134,207,2019-09-09,partly-cloudy-day,nan
671,397,274,2019-08-19,partly-cloudy-day,nan
59,46,13,2019-07-27,clear-night,nan
0,0,0,2019-01-12,clear-night,nan
0,0,0,2019-01-29,clear-night,nan
0,0,0,2019-12-02,cloudy,nan
0,0,0,2019-10-03,cloudy,nan
14,11,3,2019-11-02,cloudy,Daylight Saving Time ends
1059,419,640,2019-08-11,partly-cloudy-night,nan
229,100,129,2019-08-13,cloudy,nan
2393,1051,1342,2019-09-08,partly-cloudy-day,nan
525,201,324,2019-10-28,partly-cloudy-day,nan
104,70,34,2019-02-24,rain,nan
580,344,236,2019-01-09,clear-day,nan
2518,1200,1318,2019-12-15,partly-cloudy-day,nan
24,23,1,2019-01-25,clear-night,nan
47,36,11,2019-08-22,rain,nan
1204,611,593,2019-07-17,partly-cloudy-day,nan
13,7,6,2019-03-01,cloudy,nan
27,12,15,2019-07-06,partly-cloudy-night,nan
5,0,5,2019-09-28,clear-night,nan
1675,749,926,2019-10-08,cloudy,nan
418,176,242,2019-07-11,clear-day,nan
14,10,4,2019-09-16,partly-cloudy-night,nan
319,180,139,2019-02-13,clear-day,nan
17,12,5,2019-02-05,clear-night,nan
13,8,5,2019-05-21,clear-night,nan
2703,1046,1657,2019-07-06,rain,nan
1,0,1,2019-09-16,partly-cloudy-night,nan
120,120,0,2019-02-18,clear-night,Presidents' Day (regional holiday)
3,2,1,2019-03-03,snow,nan
1382,620,762,2019-07-08,clear-day,nan
281,124,157,2019-09-20,clear-day,nan
973,398,575,2019-11-22,cloudy,nan
16,11,5,2019-08-18,cloudy,nan
2,0,2,2019-06-21,partly-cloudy-night,nan
1531,697,834,2019-11-21,clear-day,nan
198,65,133,2019-06-10,cloudy,nan
942,396,546,2019-12-13,cloudy,nan
441,228,213,2019-03-04,cloudy,nan
1200,638,562,2019-01-01,partly-cloudy-day,New Year's Day
1136,558,578,2019-04-02,partly-cloudy-day,nan
0,0,0,2019-03-13,clear-night,nan
1862,792,1070,2019-05-06,cloudy,nan
311,128,183,2019-07-09,clear-day,nan
2327,1003,1324,2019-09-29,clear-day,nan
352,113,239,2019-09-06,cloudy,nan
1,0,1,2019-08-15,partly-cloudy-night,nan
182,98,84,2019-08-20,clear-night,nan
21,20,1,2019-02-14,partly-cloudy-night,Valentine's Day
1969,953,1016,2019-03-16,partly-cloudy-day,nan
364,163,201,2019-08-02,partly-cloudy-day,nan
612,367,245,2019-03-01,cloudy,nan
2377,1241,1136,2019-10-18,partly-cloudy-day,nan
0,0,0,2019-05-15,cloudy,nan
0,0,0,2019-05-28,clear-night,nan
2035,878,1157,2019-09-19,clear-day,nan
200,125,75,2019-08-31,partly-cloudy-night,nan
964,520,444,2019-06-26,clear-day,nan
1981,996,985,2019-03-11,clear-day,nan
5,0,5,2019-12-30,cloudy,New Year's Eve
43,16,27,2019-07-29,partly-cloudy-night,nan
0,0,0,2019-06-08,clear-night,nan
327,138,189,2019-09-24,clear-day,nan
48,46,2,2019-03-09,partly-cloudy-night,nan
55,54,1,2019-12-07,clear-night,nan
1275,514,761,2019-12-04,cloudy,nan
3,1,2,2019-07-13,clear-night,nan
1740,927,813,2019-07-03,partly-cloudy-day,nan
281,134,147,2019-05-24,clear-day,nan
7,2,5,2019-01-17,clear-night,nan
8,3,5,2019-10-09,cloudy,nan
24,12,12,2019-01-17,clear-night,nan
294,93,201,2019-01-03,partly-cloudy-day,nan
1077,613,464,2019-06-20,cloudy,nan
1,1,0,2019-03-10,cloudy,Daylight Saving Time starts
711,410,301,2019-08-12,partly-cloudy-day,nan
58,56,2,2019-05-11,partly-cloudy-night,nan
0,0,0,2019-09-29,clear-night,nan
17,14,3,2019-05-23,partly-cloudy-night,nan
0,0,0,2019-12-14,rain,nan
0,0,0,2019-10-28,clear-night,nan
1751,956,795,2019-09-24,partly-cloudy-day,nan
63,18,45,2019-08-20,partly-cloudy-night,nan
13,11,2,2019-12-23,clear-night,nan
0,0,0,2019-05-08,partly-cloudy-night,nan
7,4,3,2019-06-06,cloudy,nan
1870,839,1031,2019-11-28,partly-cloudy-day,Thanksgiving Day
0,0,0,2019-07-04,clear-night,Independence Day
1314,638,676,2019-07-17,clear-day,nan
488,283,205,2019-02-17,clear-day,nan
1553,708,845,2019-11-06,clear-day,nan
13,3,10,2019-08-21,partly-cloudy-night,nan
3243,1483,1760,2019-04-19,partly-cloudy-day,nan
20,10,10,2019-04-22,cloudy,nan
0,0,0,2019-10-17,cloudy,nan
70,66,4,2019-12-26,cloudy,nan
0,0,0,2019-03-15,clear-night,nan
1560,761,799,2019-07-10,partly-cloudy-day,nan
2086,930,1156,2019-12-06,partly-cloudy-day,nan
0,0,0,2019-12-18,clear-night,nan
1487,632,855,2019-11-17,cloudy,nan
450,207,243,2019-11-12,cloudy,nan
1606,697,909,2019-11-17,cloudy,nan
1,0,1,2019-09-04,clear-night,nan
1016,497,519,2019-02-24,cloudy,nan
3,0,3,2019-01-23,clear-night,nan
0,0,0,2019-05-06,partly-cloudy-night,nan
524,240,284,2019-03-26,clear-day,nan
1484,658,826,2019-11-05,cloudy,nan
828,374,454,2019-07-21,partly-cloudy-day,nan
1,0,1,2019-10-06,partly-cloudy-night,nan
914,372,542,2019-05-19,partly-cloudy-day,nan
2895,1249,1646,2019-07-13,clear-day,nan
165,89,76,2019-09-18,partly-cloudy-night,nan
270,114,156,2019-05-21,partly-cloudy-day,nan
573,290,283,2019-08-28,rain,nan
69,58,11,2019-06-02,partly-cloudy-night,nan
3724,1713,2011,2019-05-11,clear-day,nan
755,387,368,2019-06-20,cloudy,nan
156,82,74,2019-06-14,clear-day,nan
1,0,1,2019-12-23,clear-night,Christmas Eve
0,0,0,2019-06-17,cloudy,nan
9,8,1,2019-01-23,partly-cloudy-night,nan
22,19,3,2019-06-02,partly-cloudy-night,nan
1515,758,757,2019-07-23,cloudy,nan
56,38,18,2019-05-21,partly-cloudy-night,nan
5,0,5,2019-11-11,clear-night,nan
3,2,1,2019-01-06,partly-cloudy-night,nan
18,7,11,2019-07-22,rain,nan
0,0,0,2019-04-25,clear-night,nan
2963,1253,1710,2019-10-05,clear-day,nan
40,39,1,2019-09-22,clear-night,nan
2342,958,1384,2019-05-02,partly-cloudy-day,nan
1,1,0,2019-12-26,partly-cloudy-night,nan
1432,804,628,2019-06-17,partly-cloudy-day,nan
335,161,174,2019-05-07,partly-cloudy-night,nan
355,159,196,2019-08-09,clear-day,nan
176,81,95,2019-03-14,partly-cloudy-night,nan
0,0,0,2019-11-25,clear-night,nan
2584,989,1595,2019-11-10,partly-cloudy-day,nan
1,0,1,2019-11-22,clear-night,nan
295,126,169,2019-09-13,partly-cloudy-day,nan
1824,864,960,2019-10-24,clear-day,nan
47,28,19,2019-06-21,rain,nan
376,161,215,2019-03-19,partly-cloudy-day,nan
8,5,3,2019-01-21,clear-night,Martin Luther King Jr. Day
946,468,478,2019-06-25,partly-cloudy-day,nan
2194,1037,1157,2019-07-08,partly-cloudy-day,nan
1,0,1,2019-04-02,clear-night,nan
117,55,62,2019-05-13,cloudy,nan
98,60,38,2019-12-02,snow,nan
2231,1203,1028,2019-12-31,cloudy,New Year's Eve
1323,590,733,2019-02-18,cloudy,Presidents' Day (regional holiday)
220,100,120,2019-03-25,partly-cloudy-day,nan
2214,1187,1027,2019-10-23,clear-day,nan
0,0,0,2019-02-03,clear-night,nan
3,1,2,2019-12-15,partly-cloudy-night,nan
2468,1117,1351,2019-04-07,clear-day,nan
2534,1194,1340,2019-05-24,partly-cloudy-day,nan
3,0,3,2019-12-28,clear-night,nan
115,111,4,2019-12-20,clear-night,nan
33,33,0,2019-12-21,clear-night,nan
4,3,1,2019-01-30,clear-night,nan
24,0,24,2019-04-13,rain,nan
1664,964,700,2019-09-11,partly-cloudy-day,nan
0,0,0,2019-05-20,rain,nan
44,36,8,2019-05-03,cloudy,nan
1892,888,1004,2019-11-16,clear-day,nan
206,95,111,2019-10-08,cloudy,nan
0,0,0,2019-02-23,clear-night,nan
0,0,0,2019-03-31,clear-night,nan
3006,1600,1406,2019-08-10,clear-day,nan
11,9,2,2019-11-08,clear-night,nan
266,119,147,2019-10-05,clear-night,nan
2,1,1,2019-08-08,partly-cloudy-night,nan
159,71,88,2019-07-13,clear-day,nan
0,0,0,2019-11-03,nan,Daylight Saving Time ends
1236,625,611,2019-04-12,cloudy,nan
83,82,1,2019-12-12,clear-night,nan
447,156,291,2019-09-25,clear-day,nan
1494,767,727,2019-12-14,cloudy,nan
1749,972,777,2019-08-03,partly-cloudy-day,nan
0,0,0,2019-11-28,partly-cloudy-night,Thanksgiving Day
0,0,0,2019-03-20,clear-night,nan
6,3,3,2019-04-24,partly-cloudy-night,nan
1026,465,561,2019-01-20,partly-cloudy-day,nan
2039,880,1159,2019-08-26,partly-cloudy-day,nan
2504,1191,1313,2019-05-31,partly-cloudy-day,nan
442,263,179,2019-02-21,partly-cloudy-day,nan
1998,1019,979,2019-09-29,partly-cloudy-day,nan
237,97,140,2019-06-28,partly-cloudy-day,nan
2749,1473,1276,2019-10-13,partly-cloudy-day,nan
0,0,0,2019-11-08,partly-cloudy-night,nan
2044,958,1086,2019-06-07,clear-day,nan
356,166,190,2019-07-22,partly-cloudy-day,nan
1,0,1,2019-07-05,clear-night,nan
6,4,2,2019-02-03,clear-night,nan
90,38,52,2019-02-25,partly-cloudy-day,nan
2000,1018,982,2019-10-04,partly-cloudy-day,nan
37,14,23,2019-06-03,clear-night,nan
0,0,0,2019-07-10,clear-night,nan
183,96,87,2019-09-11,partly-cloudy-night,nan
2251,1083,1168,2019-07-13,clear-day,nan
48,44,4,2019-12-15,clear-night,nan
6,3,3,2019-08-27,clear-night,nan
1,0,1,2019-04-14,partly-cloudy-night,nan
0,0,0,2019-08-04,clear-night,nan
981,669,312,2019-04-20,rain,nan
59,58,1,2019-10-25,partly-cloudy-night,nan
302,120,182,2019-04-01,clear-day,nan
1558,689,869,2019-02-22,cloudy,nan
0,0,0,2019-01-30,partly-cloudy-night,nan
3,1,2,2019-06-19,cloudy,nan
1365,850,515,2019-08-25,partly-cloudy-day,nan
5,0,5,2019-03-21,rain,nan
2116,962,1154,2019-05-16,partly-cloudy-day,nan
22,20,2,2019-03-24,clear-night,nan
1526,918,608,2019-06-09,clear-day,nan
0,0,0,2019-11-06,clear-night,nan
2483,1406,1077,2019-04-13,cloudy,nan
0,0,0,2019-12-09,cloudy,nan
2,1,1,2019-09-18,clear-night,nan
43,19,24,2019-05-23,rain,nan
379,179,200,2019-03-15,partly-cloudy-day,nan
1,0,1,2019-02-25,clear-night,nan
13,5,8,2019-05-11,cloudy,nan
71,35,36,2019-10-27,rain,nan
5,0,5,2019-08-04,rain,nan
24,7,17,2019-06-28,partly-cloudy-night,nan
0,0,0,2019-02-01,clear-night,nan
4,0,4,2019-02-08,cloudy,nan
10,6,4,2019-09-30,cloudy,nan
2,1,1,2019-05-26,cloudy,nan
559,390,169,2019-10-06,cloudy,nan
294,134,160,2019-12-16,cloudy,nan
9,2,7,2019-06-26,partly-cloudy-night,nan
1055,491,564,2019-07-28,clear-day,nan
1442,797,645,2019-05-29,cloudy,nan
2977,1434,1543,2019-10-19,clear-day,nan
184,40,144,2019-03-10,rain,Daylight Saving Time starts
1948,835,1113,2019-04-18,cloudy,nan
582,305,277,2019-10-09,rain,nan
1079,482,597,2019-10-22,cloudy,nan
82,0,82,2019-05-01,cloudy,nan
0,0,0,2019-11-24,clear-night,nan
381,219,162,2019-02-09,clear-day,nan
1112,513,599,2019-11-07,cloudy,nan
10,7,3,2019-05-19,clear-night,nan
51,35,16,2019-08-29,clear-night,nan
42,41,1,2019-09-22,clear-night,nan
2589,1060,1529,2019-08-04,partly-cloudy-day,nan
98,94,4,2019-09-12,rain,nan
168,67,101,2019-02-14,cloudy,Valentine's Day
107,44,63,2019-08-26,partly-cloudy-night,nan
1026,568,458,2019-09-23,partly-cloudy-day,nan
782,455,327,2019-12-27,partly-cloudy-day,nan
1131,651,480,2019-03-23,partly-cloudy-day,nan
658,331,327,2019-11-18,cloudy,nan
311,134,177,2019-08-23,partly-cloudy-night,nan
2446,1107,1339,2019-04-29,clear-day,nan
1,0,1,2019-01-15,clear-night,nan
2064,991,1073,2019-10-11,cloudy,nan
202,109,93,2019-11-30,clear-night,nan
9,6,3,2019-07-04,clear-day,Independence Day
0,0,0,2019-05-30,cloudy,nan
51,34,17,2019-10-15,clear-night,nan
2,0,2,2019-03-27,clear-night,nan
57,0,57,2019-12-08,clear-night,nan
387,201,186,2019-01-23,cloudy,nan
692,364,328,2019-02-26,clear-day,nan
204,104,100,2019-01-07,clear-day,nan
1771,762,1009,2019-11-29,clear-day,Black Friday
812,390,422,2019-03-31,partly-cloudy-day,nan
2615,1338,1277,2019-07-27,partly-cloudy-day,nan
2292,969,1323,2019-10-14,clear-day,Columbus Day (regional holiday)
52,50,2,2019-11-19,partly-cloudy-night,nan
9,4,5,2019-03-04,partly-cloudy-night,nan
68,0,68,2019-02-20,cloudy,nan
86,75,11,2019-02-08,clear-night,nan
301,121,180,2019-06-12,clear-day,nan
43,16,27,2019-06-04,clear-night,nan
439,183,256,2019-08-05,partly-cloudy-day,nan
390,129,261,2019-04-09,cloudy,nan
2576,1198,1378,2019-10-04,partly-cloudy-day,nan
542,279,263,2019-07-18,rain,nan
184,54,130,2019-03-02,cloudy,nan
3587,1955,1632,2019-12-31,partly-cloudy-day,New Year's Eve
55,50,5,2019-10-28,partly-cloudy-night,nan
1799,852,947,2019-08-14,cloudy,nan
4,1,3,2019-01-28,clear-night,nan
10,7,3,2019-09-09,partly-cloudy-night,nan
2044,912,1132,2019-05-17,partly-cloudy-day,nan
194,71,123,2019-04-18,cloudy,nan
34,33,1,2019-12-12,clear-night,nan
235,100,135,2019-11-05,cloudy,nan
77,67,10,2019-07-25,clear-night,nan
1325,633,692,2019-02-04,clear-day,nan
47,0,47,2019-11-13,clear-night,nan
1182,682,500,2019-05-21,clear-day,nan
143,80,63,2019-11-24,rain,nan
7,3,4,2019-01-08,cloudy,nan
1429,698,731,2019-02-15,partly-cloudy-day,nan
89,69,20,2019-01-17,partly-cloudy-night,nan
73,72,1,2019-10-20,rain,nan
22,9,13,2019-05-19,partly-cloudy-night,nan
152,152,0,2019-02-19,clear-night,nan
2728,1228,1500,2019-11-23,clear-day,nan
1945,995,950,2019-09-13,partly-cloudy-day,nan
491,269,222,2019-06-18,cloudy,nan
3388,1304,2084,2019-10-26,partly-cloudy-day,nan
1195,641,554,2019-03-14,partly-cloudy-day,nan
204,87,117,2019-05-10,cloudy,nan
431,234,197,2019-02-07,cloudy,nan
247,175,72,2019-01-08,cloudy,nan
65,53,12,2019-09-17,clear-night,nan
1906,873,1033,2019-07-19,partly-cloudy-day,nan
1286,640,646,2019-03-18,clear-day,nan
1500,596,904,2019-06-09,clear-day,nan
381,128,253,2019-04-03,clear-day,nan
2110,1181,929,2019-10-20,partly-cloudy-day,nan
1582,850,732,2019-10-01,clear-day,nan
25,18,7,2019-06-30,partly-cloudy-night,nan
672,316,356,2019-05-15,partly-cloudy-day,nan
85,63,22,2019-06-01,clear-night,nan
38,32,6,2019-04-08,clear-night,nan
1629,715,914,2019-05-20,partly-cloudy-day,nan
1920,1011,909,2019-08-06,partly-cloudy-day,nan
1353,727,626,2019-09-27,clear-day,nan
745,396,349,2019-02-11,cloudy,nan
0,0,0,2019-08-28,partly-cloudy-night,nan
1,0,1,2019-10-16,clear-night,nan
1301,692,609,2019-05-28,cloudy,nan
2451,1212,1239,2019-04-24,clear-day,nan
41,40,1,2019-11-27,cloudy,Thanksgiving Day
710,349,361,2019-05-04,partly-cloudy-night,Cinco de Mayo
1915,1195,720,2019-06-01,clear-day,nan
3351,1561,1790,2019-06-22,partly-cloudy-day,nan
83,51,32,2019-03-27,clear-night,nan
58,34,24,2019-08-07,rain,nan
2,1,1,2019-09-07,cloudy,nan
1521,697,824,2019-09-18,partly-cloudy-day,nan
382,152,230,2019-10-22,cloudy,nan
14,13,1,2019-10-15,clear-night,nan
46,39,7,2019-06-06,clear-night,nan
292,108,184,2019-04-12,cloudy,nan
1280,771,509,2019-06-16,partly-cloudy-day,Father's Day
219,122,97,2019-03-21,rain,nan
919,355,564,2019-04-14,cloudy,nan
33,23,10,2019-02-21,clear-night,nan
1661,844,817,2019-08-13,partly-cloudy-day,nan
1,0,1,2019-12-03,clear-night,nan
22,0,22,2019-02-16,clear-night,nan
0,0,0,2019-11-15,clear-night,nan
0,0,0,2019-04-26,partly-cloudy-night,nan
0,0,0,2019-06-13,partly-cloudy-night,nan
0,0,0,2019-09-19,clear-night,nan
0,0,0,2019-04-17,cloudy,nan
2159,978,1181,2019-08-17,partly-cloudy-day,nan
33,22,11,2019-03-16,clear-night,nan
10,0,10,2019-12-13,rain,nan
44,10,34,2019-05-26,partly-cloudy-night,Memorial Day
184,143,41,2019-01-02,partly-cloudy-night,nan
159,74,85,2019-05-05,rain,Cinco de Mayo
357,222,135,2019-07-07,cloudy,nan
275,104,171,2019-09-05,partly-cloudy-day,nan
817,372,445,2019-04-03,clear-day,nan
3,2,1,2019-02-27,cloudy,nan
18,0,18,2019-10-22,rain,nan
997,447,550,2019-03-07,cloudy,nan
1879,898,981,2019-08-02,partly-cloudy-day,nan
35,34,1,2019-12-22,clear-night,nan
50,43,7,2019-08-18,partly-cloudy-night,nan
566,277,289,2019-05-16,partly-cloudy-day,nan
1,0,1,2019-07-02,clear-night,nan
13,6,7,2019-06-19,cloudy,nan
0,0,0,2019-02-02,clear-day,nan
1,1,0,2019-03-02,cloudy,nan
394,174,220,2019-10-14,cloudy,Columbus Day (regional holiday)
1642,942,700,2019-06-27,partly-cloudy-day,nan
1383,792,591,2019-11-09,clear-day,nan
17,9,8,2019-09-23,partly-cloudy-night,nan
724,334,390,2019-01-30,clear-day,nan
3,2,1,2019-10-14,clear-night,nan
680,408,272,2019-12-24,clear-day,Christmas Eve
0,0,0,2019-03-26,clear-night,nan
0,0,0,2019-02-05,clear-night,nan
1158,657,501,2019-05-27,clear-day,Memorial Day
248,141,107,2019-01-18,cloudy,nan
10,3,7,2019-01-02,partly-cloudy-night,nan
8,0,8,2019-10-03,rain,nan
556,294,262,2019-08-28,cloudy,nan
1,0,1,2019-11-19,cloudy,nan
1967,1103,864,2019-08-05,partly-cloudy-day,nan
429,197,232,2019-10-25,clear-day,nan
30,0,30,2019-12-05,clear-night,nan
10,1,9,2019-07-14,clear-night,nan
1601,728,873,2019-10-29,cloudy,nan
1580,705,875,2019-02-10,clear-day,nan
40,38,2,2019-02-06,rain,nan
1303,715,588,2019-07-12,partly-cloudy-day,nan
1674,734,940,2019-05-09,cloudy,nan
786,430,356,2019-06-07,clear-day,nan
868,369,499,2019-02-13,partly-cloudy-day,nan
0,0,0,2019-08-17,cloudy,nan
354,149,205,2019-10-02,partly-cloudy-day,nan
942,628,314,2019-09-08,partly-cloudy-day,nan
9,1,8,2019-01-13,cloudy,nan
24,15,9,2019-12-10,cloudy,nan
1143,662,481,2019-09-04,partly-cloudy-day,nan
3,3,0,2019-03-09,cloudy,nan
2,0,2,2019-11-19,rain,nan
1231,438,793,2019-05-18,clear-day,nan
954,496,458,2019-03-25,cloudy,nan
1186,529,657,2019-10-29,cloudy,nan
2057,878,1179,2019-10-15,clear-day,nan
1917,950,967,2019-03-22,partly-cloudy-day,nan
2036,1039,997,2019-06-14,partly-cloudy-day,nan
0,0,0,2019-07-20,clear-night,nan
1410,622,788,2019-06-21,clear-day,nan
120,77,43,2019-03-10,cloudy,Daylight Saving Time starts
0,0,0,2019-11-02,clear-night,nan
1458,836,622,2019-06-05,partly-cloudy-day,nan
3022,1373,1649,2019-08-31,partly-cloudy-day,nan
1701,862,839,2019-08-27,partly-cloudy-day,nan
1153,601,552,2019-09-05,partly-cloudy-day,nan
717,367,350,2019-03-10,rain,Daylight Saving Time starts
0,0,0,2019-03-22,rain,nan
1588,726,862,2019-07-30,partly-cloudy-day,nan
1195,680,515,2019-08-29,clear-day,nan
20,19,1,2019-12-19,partly-cloudy-night,nan
5,0,5,2019-12-28,clear-night,nan
3,0,3,2019-12-10,cloudy,nan
110,53,57,2019-05-01,cloudy,nan
1292,543,749,2019-07-24,partly-cloudy-day,nan
16,13,3,2019-09-03,clear-night,nan
565,281,284,2019-12-05,partly-cloudy-day,nan
1118,503,615,2019-02-26,partly-cloudy-day,nan
1368,631,737,2019-03-08,partly-cloudy-day,nan
2,1,1,2019-11-03,clear-night,nan
92,65,27,2019-02-27,cloudy,nan
2007,925,1082,2019-05-17,partly-cloudy-day,nan
1985,1235,750,2019-05-25,clear-day,nan
42,17,25,2019-08-09,partly-cloudy-night,nan
27,12,15,2019-06-24,partly-cloudy-night,nan
951,446,505,2019-01-13,partly-cloudy-day,nan
1621,776,845,2019-12-29,cloudy,nan
1288,755,533,2019-06-12,clear-day,nan
1076,577,499,2019-03-28,partly-cloudy-day,nan
0,0,0,2019-12-07,clear-night,nan
55,37,18,2019-11-24,rain,nan
494,225,269,2019-05-11,partly-cloudy-night,Mother's Day
12,3,9,2019-06-17,partly-cloudy-night,nan
1104,631,473,2019-06-22,clear-day,nan
15,13,2,2019-03-13,clear-night,nan
1559,800,759,2019-03-03,partly-cloudy-day,nan
28,27,1,2019-11-02,partly-cloudy-night,Daylight Saving Time ends
1388,636,752,2019-12-20,clear-day,nan
192,56,136,2019-01-14,partly-cloudy-day,nan
2541,1098,1443,2019-06-08,partly-cloudy-day,nan
118,87,31,2019-09-22,clear-night,nan
1564,721,843,2019-04-01,clear-day,nan
394,187,207,2019-10-09,cloudy,nan
3371,2061,1310,2019-12-28,clear-day,nan
127,61,66,2019-01-24,rain,nan
2122,1152,970,2019-09-20,clear-day,nan
15,12,3,2019-07-11,cloudy,nan
197,99,98,2019-12-01,partly-cloudy-day,nan
0,0,0,2019-02-26,clear-night,nan
4,0,4,2019-12-14,rain,nan
1486,838,648,2019-09-02,partly-cloudy-day,Labor Day
121,63,58,2019-09-12,partly-cloudy-night,nan
0,0,0,2019-12-23,clear-night,nan
71,46,25,2019-04-15,partly-cloudy-night,nan
2059,1284,775,2019-12-29,partly-cloudy-day,nan
2,1,1,2019-04-11,clear-night,nan
129,63,66,2019-12-21,partly-cloudy-night,nan
305,158,147,2019-07-18,cloudy,nan
1993,1001,992,2019-07-26,partly-cloudy-day,nan
284,114,170,2019-11-20,partly-cloudy-day,nan
0,0,0,2019-03-28,clear-night,nan
1613,581,1032,2019-04-28,cloudy,nan
1089,539,550,2019-03-05,clear-day,nan
14,14,0,2019-03-23,clear-night,nan
3,2,1,2019-09-28,clear-night,nan
731,418,313,2019-07-14,clear-day,nan
1,0,1,2019-06-30,clear-night,nan
1585,633,952,2019-04-28,cloudy,nan
4,0,4,2019-06-23,clear-night,nan
1,1,0,2019-01-19,clear-night,nan
2362,1123,1239,2019-08-08,partly-cloudy-day,nan
0,0,0,2019-03-17,clear-night,St. Patrick's Day
152,40,112,2019-10-03,rain,nan
2100,952,1148,2019-06-11,clear-day,nan
2155,937,1218,2019-06-11,clear-day,nan
21,0,21,2019-03-31,clear-night,nan
2991,1336,1655,2019-01-02,partly-cloudy-day,nan
1263,621,642,2019-08-28,cloudy,nan
101,34,67,2019-03-21,cloudy,nan
0,0,0,2019-09-20,clear-night,nan
99,54,45,2019-03-05,clear-night,nan
22,21,1,2019-11-26,clear-night,nan
1318,662,656,2019-02-22,clear-day,nan
1,0,1,2019-07-12,cloudy,nan
1,0,1,2019-03-12,clear-night,nan
2370,1136,1234,2019-10-21,clear-day,nan
2,0,2,2019-07-26,clear-night,nan
2553,1281,1272,2019-04-16,clear-day,nan
2606,1182,1424,2019-09-15,partly-cloudy-day,nan
3,2,1,2019-10-27,partly-cloudy-night,nan
510,254,256,2019-12-09,rain,nan
111,50,61,2019-11-13,clear-day,nan
1,0,1,2019-07-06,cloudy,nan
0,0,0,2019-04-11,clear-night,nan
1,0,1,2019-02-21,cloudy,nan
2590,1196,1394,2019-03-09,clear-day,nan
33,27,6,2019-03-03,cloudy,nan
94,93,1,2019-05-30,rain,nan
1,0,1,2019-01-02,partly-cloudy-night,nan
58,32,26,2019-02-22,clear-night,nan
2231,1080,1151,2019-06-03,clear-day,nan
2138,950,1188,2019-11-01,clear-day,nan
24,8,16,2019-07-18,cloudy,nan
81,0,81,2019-11-14,clear-night,nan
8,5,3,2019-08-23,cloudy,nan
1559,710,849,2019-04-30,cloudy,nan
4,2,2,2019-11-30,clear-night,nan
11,7,4,2019-07-07,partly-cloudy-night,nan
430,166,264,2019-07-29,clear-day,nan
8,5,3,2019-06-27,clear-night,nan
4,1,3,2019-08-12,clear-night,nan
2134,922,1212,2019-08-30,clear-day,nan
2702,1160,1542,2019-08-11,partly-cloudy-day,nan
1855,851,1004,2019-03-20,clear-day,nan
1385,899,486,2019-12-25,clear-day,Christmas Day
4,3,1,2019-11-04,clear-night,nan
1961,764,1197,2019-08-19,clear-day,nan
1733,974,759,2019-07-02,partly-cloudy-day,nan
0,0,0,2019-01-28,clear-night,nan
1852,775,1077,2019-12-24,clear-day,Christmas Eve
9,7,2,2019-05-04,partly-cloudy-night,nan
410,224,186,2019-01-11,clear-night,nan
1805,872,933,2019-10-07,partly-cloudy-day,nan
527,269,258,2019-11-04,partly-cloudy-night,nan
56,54,2,2019-12-07,clear-night,nan
145,66,79,2019-11-09,clear-day,nan
2,0,2,2019-06-09,clear-night,nan
0,0,0,2019-06-12,clear-night,nan
723,420,303,2019-08-20,partly-cloudy-day,nan
64,55,9,2019-07-13,clear-night,nan
3894,1604,2290,2019-04-21,cloudy,Easter Sunday
5,2,3,2019-01-17,clear-night,nan
27,24,3,2019-03-09,clear-night,nan
447,164,283,2019-05-16,partly-cloudy-day,nan
3,0,3,2019-01-03,cloudy,nan
14,12,2,2019-02-13,clear-night,nan
912,410,502,2019-02-28,partly-cloudy-day,nan
0,0,0,2019-01-31,clear-night,nan
1035,465,570,2019-06-26,clear-day,nan
1741,741,1000,2019-05-14,cloudy,nan
3,3,0,2019-09-06,partly-cloudy-night,nan
38,36,2,2019-12-25,clear-night,Christmas Day
0,0,0,2019-07-09,clear-night,nan
1609,877,732,2019-05-24,clear-day,nan
16,12,4,2019-08-29,partly-cloudy-night,nan
85,80,5,2019-05-16,clear-night,nan
0,0,0,2019-07-04,clear-night,nan
2219,1039,1180,2019-02-23,clear-day,nan
855,400,455,2019-10-29,rain,nan
1190,436,754,2019-11-21,clear-day,nan
48,26,22,2019-05-15,partly-cloudy-night,nan
1023,610,413,2019-07-09,clear-day,nan
1109,474,635,2019-11-14,cloudy,nan
4008,1994,2014,2019-01-01,partly-cloudy-day,New Year's Day
10,6,4,2019-10-09,cloudy,nan
0,0,0,2019-03-13,clear-night,nan
35,20,15,2019-08-15,cloudy,nan
0,0,0,2019-10-15,clear-night,nan
1597,686,911,2019-08-21,rain,nan
3308,1434,1874,2019-06-15,partly-cloudy-day,nan
3166,1165,2001,2019-04-19,partly-cloudy-day,nan
1,0,1,2019-04-08,cloudy,nan
2276,987,1289,2019-05-02,clear-day,nan
1323,689,634,2019-07-08,rain,nan
1,0,1,2019-06-14,cloudy,nan
0,0,0,2019-05-14,cloudy,nan
1,0,1,2019-10-31,rain,Halloween
38,26,12,2019-05-07,cloudy,nan
0,0,0,2019-12-21,clear-night,nan
5,0,5,2019-07-01,clear-night,nan
160,158,2,2019-01-24,partly-cloudy-night,nan
75,35,40,2019-10-31,rain,Halloween
1271,635,636,2019-07-17,partly-cloudy-day,nan
67,61,6,2019-11-26,clear-night,nan
1180,613,567,2019-05-23,rain,nan
1,1,0,2019-08-10,clear-night,nan
656,329,327,2019-07-22,rain,nan
5,0,5,2019-07-24,cloudy,nan
2,0,2,2019-10-01,cloudy,nan
1,0,1,2019-09-18,clear-night,nan
2612,1150,1462,2019-03-16,partly-cloudy-day,nan
1139,534,605,2019-03-01,cloudy,nan
1254,479,775,2019-06-01,clear-day,nan
1734,787,947,2019-10-30,cloudy,nan
28,21,7,2019-04-24,clear-night,nan
81,39,42,2019-04-28,partly-cloudy-night,nan
0,0,0,2019-07-10,partly-cloudy-night,nan
84,0,84,2019-11-17,cloudy,nan
2090,849,1241,2019-03-24,clear-day,nan
166,60,106,2019-07-04,clear-day,Independence Day
9,9,0,2019-03-26,clear-night,nan
1898,979,919,2019-05-17,partly-cloudy-day,nan
813,358,455,2019-01-08,cloudy,nan
6,5,1,2019-12-20,clear-night,nan
1000,562,438,2019-09-09,partly-cloudy-day,nan
1890,878,1012,2019-09-09,partly-cloudy-day,nan
0,0,0,2019-11-23,clear-night,nan
1803,851,952,2019-11-17,cloudy,nan
2224,1286,938,2019-04-23,clear-day,nan
1066,587,479,2019-09-30,partly-cloudy-day,nan
276,108,168,2019-03-15,partly-cloudy-day,nan
3912,2279,1633,2019-05-11,clear-day,nan
1714,793,921,2019-07-26,partly-cloudy-day,nan
0,0,0,2019-12-18,partly-cloudy-night,nan
0,0,0,2019-03-11,clear-night,nan
2,0,2,2019-02-24,rain,nan
0,0,0,2019-11-06,partly-cloudy-night,nan
0,0,0,2019-09-03,clear-night,nan
1769,802,967,2019-06-19,cloudy,nan
439,191,248,2019-05-10,partly-cloudy-night,nan
0,0,0,2019-04-22,clear-night,Easter Monday
293,99,194,2019-11-05,cloudy,nan
0,0,0,2019-01-30,clear-night,nan
1,0,1,2019-12-04,clear-night,nan
109,96,13,2019-06-22,clear-night,nan
229,154,75,2019-12-09,rain,nan
122,53,69,2019-09-30,cloudy,nan
1125,617,508,2019-09-19,clear-day,nan
1438,740,698,2019-04-08,cloudy,nan
1731,768,963,2019-07-15,partly-cloudy-day,nan
0,0,0,2019-08-09,partly-cloudy-night,nan
0,0,0,2019-02-02,partly-cloudy-day,nan
12,8,4,2019-05-07,rain,nan
1943,1052,891,2019-06-03,clear-day,nan
25,19,6,2019-09-11,partly-cloudy-night,nan
65,61,4,2019-07-03,clear-night,Independence Day
152,69,83,2019-05-20,partly-cloudy-day,nan
3,2,1,2019-08-28,partly-cloudy-night,nan
655,298,357,2019-04-05,cloudy,nan
700,292,408,2019-04-25,cloudy,nan
3,2,1,2019-11-22,clear-night,nan
620,283,337,2019-01-16,cloudy,nan
2210,1028,1182,2019-10-23,clear-day,nan
0,0,0,2019-10-19,clear-night,nan
0,0,0,2019-11-17,partly-cloudy-night,nan
0,0,0,2019-12-15,partly-cloudy-night,nan
3398,1622,1776,2019-05-26,clear-day,nan
190,99,91,2019-09-04,cloudy,nan
8,7,1,2019-12-21,partly-cloudy-night,nan
1,0,1,2019-01-22,clear-night,nan
1,0,1,2019-06-26,clear-night,nan
2,0,2,2019-03-19,clear-night,nan
8,6,2,2019-10-31,wind,nan
2587,1161,1426,2019-10-14,clear-day,Columbus Day (regional holiday)
30,21,9,2019-05-29,cloudy,nan
7,3,4,2019-12-27,cloudy,nan
0,0,0,2019-10-08,rain,nan
247,132,115,2019-07-18,rain,nan
2689,1120,1569,2019-11-10,cloudy,nan
1768,691,1077,2019-05-08,partly-cloudy-day,nan
1413,630,783,2019-09-25,clear-day,nan
0,0,0,2019-11-03,clear-night,Daylight Saving Time ends
0,0,0,2019-08-05,clear-night,nan
860,472,388,2019-01-05,cloudy,nan
300,128,172,2019-04-23,partly-cloudy-night,nan
66,38,28,2019-06-09,clear-night,nan
0,0,0,2019-10-09,cloudy,nan
332,128,204,2019-03-21,cloudy,nan
4,2,2,2019-07-31,clear-night,nan
0,0,0,2019-04-15,rain,Tax Day
2389,1365,1024,2019-08-08,partly-cloudy-day,nan
1659,956,703,2019-09-10,partly-cloudy-day,nan
77,68,9,2019-07-13,clear-night,nan
2114,1022,1092,2019-05-31,partly-cloudy-day,nan
637,363,274,2019-02-25,partly-cloudy-day,nan
17,0,17,2019-04-12,cloudy,nan
1435,681,754,2019-03-19,clear-day,nan
1386,636,750,2019-02-22,clear-day,nan
2094,971,1123,2019-06-30,partly-cloudy-day,nan
2413,1083,1330,2019-09-22,clear-day,nan
560,258,302,2019-04-03,clear-day,nan
0,0,0,2019-11-28,partly-cloudy-night,Thanksgiving Day
63,0,63,2019-11-20,partly-cloudy-night,nan
1020,569,451,2019-01-25,partly-cloudy-day,nan
2,1,1,2019-02-25,partly-cloudy-night,nan
2490,1083,1407,2019-05-31,clear-day,nan
2,1,1,2019-05-12,rain,Mother's Day
80,41,39,2019-06-02,partly-cloudy-night,nan
68,57,11,2019-01-26,cloudy,nan
7,0,7,2019-02-04,clear-night,nan
4,0,4,2019-03-04,partly-cloudy-night,nan
0,0,0,2019-11-11,clear-night,Veterans Day
258,148,110,2019-04-05,rain,nan
66,64,2,2019-11-15,clear-night,nan
0,0,0,2019-09-29,clear-night,nan
1,0,1,2019-02-08,cloudy,nan
13,5,8,2019-01-30,clear-night,nan
66,35,31,2019-02-01,clear-night,nan
80,60,20,2019-05-26,cloudy,nan
1,1,0,2019-07-19,cloudy,nan
811,443,368,2019-02-03,clear-day,nan
1,1,0,2019-11-25,clear-night,nan
1,0,1,2019-01-06,partly-cloudy-night,nan
195,64,131,2019-01-15,clear-day,nan
3,0,3,2019-12-09,rain,nan
606,201,405,2019-06-07,partly-cloudy-day,nan
465,215,250,2019-10-18,partly-cloudy-day,nan
535,273,262,2019-04-22,rain,Easter Monday
22,15,7,2019-05-11,cloudy,nan
0,0,0,2019-12-22,clear-night,nan
0,0,0,2019-03-18,clear-night,nan
2637,1184,1453,2019-08-03,partly-cloudy-day,nan
0,0,0,2019-10-06,partly-cloudy-night,nan
1,0,1,2019-06-22,clear-night,nan
1130,484,646,2019-05-28,cloudy,nan
0,0,0,2019-09-21,clear-night,nan
3267,1790,1477,2019-12-27,partly-cloudy-day,nan
733,319,414,2019-02-24,cloudy,nan
118,51,67,2019-02-23,clear-day,nan
1,0,1,2019-06-28,clear-night,nan
84,56,28,2019-07-01,clear-night,nan
5,4,1,2019-12-03,cloudy,nan
1836,990,846,2019-08-02,partly-cloudy-day,nan
1,0,1,2019-05-23,partly-cloudy-night,nan
28,26,2,2019-11-24,partly-cloudy-night,nan
0,0,0,2019-04-02,clear-night,nan
11,7,4,2019-08-04,rain,nan
971,512,459,2019-03-07,partly-cloudy-day,nan
1765,962,803,2019-03-02,cloudy,nan
2007,996,1011,2019-05-17,partly-cloudy-day,nan
1903,896,1007,2019-10-07,partly-cloudy-day,nan
0,0,0,2019-12-08,cloudy,nan
50,34,16,2019-06-06,cloudy,nan
1321,667,654,2019-09-12,cloudy,nan
59,54,5,2019-08-04,partly-cloudy-night,nan
65,25,40,2019-06-10,partly-cloudy-night,nan
2474,1111,1363,2019-04-17,clear-day,nan
634,314,320,2019-12-06,partly-cloudy-day,nan
1855,817,1038,2019-06-17,cloudy,nan
4,2,2,2019-08-24,clear-night,nan
1391,669,722,2019-05-09,cloudy,nan
2592,1078,1514,2019-04-14,cloudy,nan
53,52,1,2019-12-15,clear-night,nan
276,105,171,2019-03-18,clear-day,nan
1381,641,740,2019-05-01,cloudy,nan
0,0,0,2019-02-08,clear-night,nan
31,15,16,2019-01-15,clear-night,nan
1125,1125,0,2019-02-19,clear-day,nan
3177,1381,1796,2019-10-05,clear-day,nan
21,20,1,2019-06-06,partly-cloudy-night,nan
174,121,53,2019-09-08,clear-night,nan
0,0,0,2019-09-26,clear-night,nan
3189,1408,1781,2019-09-07,partly-cloudy-day,nan
84,71,13,2019-09-21,clear-night,nan
3,1,2,2019-08-27,clear-night,nan
2665,1163,1502,2019-09-29,clear-day,nan
0,0,0,2019-03-25,partly-cloudy-night,nan
3138,1421,1717,2019-10-19,clear-day,nan
839,517,322,2019-08-09,clear-day,nan
2063,1097,966,2019-08-26,partly-cloudy-day,nan
380,106,274,2019-07-10,partly-cloudy-day,nan
1852,974,878,2019-05-20,partly-cloudy-day,nan
2738,1152,1586,2019-07-27,partly-cloudy-day,nan
0,0,0,2019-12-01,clear-night,nan
2252,1350,902,2019-06-08,clear-day,nan
2784,1131,1653,2019-04-13,partly-cloudy-day,nan
900,309,591,2019-08-01,partly-cloudy-day,nan
3322,1499,1823,2019-03-30,clear-day,nan
0,0,0,2019-01-09,partly-cloudy-night,nan
613,312,301,2019-12-10,cloudy,nan
1469,655,814,2019-07-18,rain,nan
11,2,9,2019-03-02,cloudy,nan
2142,1109,1033,2019-07-04,partly-cloudy-day,Independence Day
1486,634,852,2019-11-19,cloudy,nan
0,0,0,2019-02-14,cloudy,Valentine's Day
0,0,0,2019-02-17,clear-night,nan
1885,864,1021,2019-09-16,cloudy,nan
1317,678,639,2019-05-07,clear-day,nan
173,115,58,2019-06-10,rain,nan
803,441,362,2019-10-14,cloudy,Columbus Day (regional holiday)
0,0,0,2019-09-01,clear-night,nan
1544,732,812,2019-02-09,clear-day,nan
79,53,26,2019-10-04,clear-night,nan
932,486,446,2019-04-25,clear-day,nan
0,0,0,2019-04-18,partly-cloudy-night,nan
1812,934,878,2019-06-04,clear-day,nan
3146,1555,1591,2019-12-31,clear-day,New Year's Eve
0,0,0,2019-04-09,cloudy,nan
286,119,167,2019-11-16,clear-day,nan
786,368,418,2019-01-23,cloudy,nan
3,1,2,2019-01-20,rain,nan
8,4,4,2019-08-08,partly-cloudy-night,nan
2403,1097,1306,2019-08-16,partly-cloudy-day,nan
1397,811,586,2019-06-26,partly-cloudy-day,nan
1126,478,648,2019-01-07,clear-day,nan
3050,1564,1486,2019-12-31,cloudy,New Year's Eve
1,0,1,2019-10-20,partly-cloudy-night,nan
1370,732,638,2019-09-13,partly-cloudy-day,nan
3356,1509,1847,2019-04-23,partly-cloudy-day,nan
2,1,1,2019-09-10,partly-cloudy-night,nan
4,0,4,2019-12-11,rain,nan
13,8,5,2019-08-06,partly-cloudy-night,nan
1447,764,683,2019-11-23,clear-day,nan
371,155,216,2019-08-28,cloudy,nan
307,163,144,2019-03-06,clear-day,nan
26,18,8,2019-04-11,cloudy,nan
0,0,0,2019-11-30,partly-cloudy-night,nan
0,0,0,2019-03-22,rain,nan
0,0,0,2019-02-04,clear-night,nan
0,0,0,2019-04-23,partly-cloudy-night,nan
1,0,1,2019-10-26,clear-night,nan
461,246,215,2019-11-24,rain,nan
1436,859,577,2019-09-08,partly-cloudy-day,nan
963,413,550,2019-02-07,cloudy,nan
310,116,194,2019-12-05,partly-cloudy-day,nan
7,3,4,2019-09-18,clear-night,nan
0,0,0,2019-11-20,cloudy,nan
24,11,13,2019-01-24,rain,nan
1,0,1,2019-09-10,partly-cloudy-night,nan
0,0,0,2019-05-10,cloudy,nan
12,0,12,2019-03-17,cloudy,St. Patrick's Day
3,0,3,2019-12-11,clear-night,nan
1576,925,651,2019-08-11,clear-day,nan
390,191,199,2019-12-02,snow,nan
1835,793,1042,2019-09-18,partly-cloudy-day,nan
1,0,1,2019-04-24,cloudy,nan
2260,974,1286,2019-06-21,partly-cloudy-day,nan
3275,1513,1762,2019-05-27,clear-day,Memorial Day
2027,935,1092,2019-06-16,cloudy,Father's Day
1952,880,1072,2019-01-27,partly-cloudy-day,nan
1310,593,717,2019-02-05,clear-day,nan
3,0,3,2019-06-10,clear-night,nan
8,4,4,2019-03-20,clear-night,nan
0,0,0,2019-08-12,clear-night,nan
228,112,116,2019-05-25,clear-day,nan
911,409,502,2019-02-27,partly-cloudy-day,nan
1966,869,1097,2019-05-21,clear-day,nan
1,0,1,2019-05-22,clear-night,nan
6,6,0,2019-12-24,clear-night,Christmas Day
497,225,272,2019-09-02,rain,Labor Day
38,18,20,2019-11-18,cloudy,nan
4,2,2,2019-08-08,partly-cloudy-night,nan
2,2,0,2019-04-30,cloudy,nan
727,363,364,2019-07-01,clear-day,nan
873,524,349,2019-10-06,cloudy,nan
1214,592,622,2019-09-02,cloudy,Labor Day
2154,1042,1112,2019-09-27,clear-day,nan
175,90,85,2019-08-06,partly-cloudy-night,nan
870,404,466,2019-08-22,partly-cloudy-day,nan
1573,662,911,2019-07-22,partly-cloudy-day,nan
1974,841,1133,2019-07-19,partly-cloudy-day,nan
1491,671,820,2019-12-16,partly-cloudy-day,nan
483,273,210,2019-04-01,clear-day,nan
8,7,1,2019-09-26,clear-night,nan
0,0,0,2019-04-11,clear-night,nan
2795,1142,1653,2019-06-01,clear-day,nan
141,47,94,2019-02-15,cloudy,nan
0,0,0,2019-03-05,partly-cloudy-night,nan
37,23,14,2019-01-08,cloudy,nan
666,367,299,2019-07-12,partly-cloudy-day,nan
0,0,0,2019-08-19,clear-night,nan
51,26,25,2019-01-01,partly-cloudy-night,New Year's Day
2037,1033,1004,2019-10-15,clear-day,nan
2261,964,1297,2019-08-05,partly-cloudy-day,nan
51,30,21,2019-02-17,cloudy,nan
430,204,226,2019-10-03,rain,nan
1663,800,863,2019-09-24,partly-cloudy-day,nan
61,60,1,2019-10-24,clear-night,nan
1791,1000,791,2019-06-24,partly-cloudy-day,nan
27,0,27,2019-02-21,clear-night,nan
2135,975,1160,2019-07-01,partly-cloudy-day,nan
341,179,162,2019-03-27,clear-day,nan
2367,1036,1331,2019-08-02,partly-cloudy-day,nan
395,150,245,2019-04-17,cloudy,nan
23,15,8,2019-09-28,partly-cloudy-night,nan
3,2,1,2019-02-24,partly-cloudy-night,nan
984,537,447,2019-10-28,partly-cloudy-day,nan
1,0,1,2019-12-13,cloudy,nan
0,0,0,2019-03-13,clear-night,nan
1948,1047,901,2019-08-30,partly-cloudy-day,nan
1006,465,541,2019-01-18,cloudy,nan
60,28,32,2019-02-06,clear-night,nan
0,0,0,2019-11-22,cloudy,nan
1218,629,589,2019-03-20,clear-day,nan
0,0,0,2019-09-14,partly-cloudy-night,nan
1561,660,901,2019-10-17,cloudy,nan
0,0,0,2019-10-22,cloudy,nan
0,0,0,2019-10-04,cloudy,nan
1,0,1,2019-06-24,clear-night,nan
0,0,0,2019-12-30,rain,nan
777,453,324,2019-08-05,partly-cloudy-day,nan
1413,632,781,2019-08-22,clear-day,nan
408,165,243,2019-09-23,partly-cloudy-night,nan
2,0,2,2019-12-24,clear-night,Christmas Eve
19,13,6,2019-09-20,clear-night,nan
396,226,170,2019-07-14,clear-day,nan
95,38,57,2019-04-26,rain,nan
0,0,0,2019-10-02,partly-cloudy-night,nan
2067,895,1172,2019-03-03,cloudy,nan
13,9,4,2019-12-19,clear-night,nan
41,19,22,2019-01-02,cloudy,nan
3,3,0,2019-10-02,cloudy,nan
1,1,0,2019-03-09,cloudy,nan
0,0,0,2019-07-07,partly-cloudy-night,nan
25,13,12,2019-08-13,cloudy,nan
128,78,50,2019-08-23,cloudy,nan
440,259,181,2019-02-10,clear-day,nan
46,24,22,2019-01-04,partly-cloudy-night,nan
2,0,2,2019-04-09,cloudy,nan
21,16,5,2019-01-26,clear-night,nan
2129,973,1156,2019-07-12,partly-cloudy-day,nan
2545,1244,1301,2019-08-10,partly-cloudy-day,nan
438,172,266,2019-07-25,partly-cloudy-day,nan
1,0,1,2019-02-26,clear-night,nan
954,415,539,2019-03-07,partly-cloudy-day,nan
145,89,56,2019-12-25,clear-night,Christmas Day
100,30,70,2019-06-13,cloudy,nan
434,175,259,2019-09-19,clear-day,nan
900,466,434,2019-08-17,partly-cloudy-day,nan
0,0,0,2019-02-12,cloudy,nan
4,1,3,2019-05-15,cloudy,nan
2,1,1,2019-12-10,cloudy,nan
0,0,0,2019-01-12,partly-cloudy-night,nan
20,15,5,2019-09-04,clear-night,nan
74,59,15,2019-06-27,clear-night,nan
0,0,0,2019-02-02,clear-night,nan
2,0,2,2019-09-23,clear-night,nan
1821,800,1021,2019-03-14,partly-cloudy-day,nan
40,25,15,2019-02-28,partly-cloudy-night,nan
205,94,111,2019-07-21,clear-day,nan
128,46,82,2019-06-29,partly-cloudy-night,nan
319,180,139,2019-02-06,cloudy,nan
2323,800,1523,2019-10-10,partly-cloudy-day,nan
73,70,3,2019-10-22,rain,nan
0,0,0,2019-10-17,cloudy,nan
1458,629,829,2019-05-09,cloudy,nan
163,63,100,2019-01-18,cloudy,nan
2630,1190,1440,2019-12-15,partly-cloudy-day,nan
1726,876,850,2019-02-16,clear-day,nan
84,41,43,2019-11-24,rain,nan
2247,821,1426,2019-04-20,partly-cloudy-day,nan
857,383,474,2019-07-30,clear-day,nan
1,0,1,2019-05-03,cloudy,nan
713,305,408,2019-01-14,clear-day,nan
1833,923,910,2019-07-14,partly-cloudy-day,nan
3538,1660,1878,2019-05-25,partly-cloudy-day,nan
1087,450,637,2019-10-16,cloudy,nan
59,58,1,2019-11-06,clear-night,nan
51,43,8,2019-05-19,clear-night,nan
2324,1073,1251,2019-09-01,partly-cloudy-day,nan
5,0,5,2019-11-18,rain,nan
1643,771,872,2019-07-09,clear-day,nan
2042,896,1146,2019-06-12,partly-cloudy-day,nan
964,671,293,2019-06-02,partly-cloudy-day,nan
681,336,345,2019-03-22,cloudy,nan
225,72,153,2019-01-07,clear-day,nan
2977,1343,1634,2019-10-28,cloudy,nan
188,72,116,2019-03-07,partly-cloudy-day,nan
7,7,0,2019-12-25,clear-night,nan
2548,1187,1361,2019-10-21,clear-day,nan
7,0,7,2019-12-22,clear-night,nan
1466,637,829,2019-06-05,clear-day,nan
45,27,18,2019-08-31,clear-night,nan
0,0,0,2019-11-11,clear-night,nan
3,2,1,2019-07-02,clear-night,nan
1977,926,1051,2019-09-05,partly-cloudy-day,nan
147,72,75,2019-12-16,cloudy,nan
2785,1315,1470,2019-05-06,partly-cloudy-day,nan
0,0,0,2019-04-16,partly-cloudy-night,nan
3279,1586,1693,2019-06-22,partly-cloudy-day,nan
432,183,249,2019-07-26,clear-day,nan
2144,1147,997,2019-04-24,clear-day,nan
700,347,353,2019-01-10,cloudy,nan
544,339,205,2019-12-09,rain,nan
878,495,383,2019-08-28,cloudy,nan
1096,635,461,2019-12-28,clear-day,nan
2590,1167,1423,2019-06-14,cloudy,nan
7,2,5,2019-03-31,clear-night,nan
250,87,163,2019-03-26,clear-day,nan
0,0,0,2019-09-12,partly-cloudy-night,nan
8,5,3,2019-07-13,clear-night,nan
2039,946,1093,2019-08-27,partly-cloudy-day,nan
3173,1930,1243,2019-12-26,partly-cloudy-day,nan
66,39,27,2019-03-10,rain,Daylight Saving Time starts
3099,1623,1476,2019-12-29,cloudy,nan
2008,903,1105,2019-06-09,clear-day,nan
1759,801,958,2019-06-04,clear-day,nan
1681,855,826,2019-06-27,partly-cloudy-day,nan
4,1,3,2019-01-13,cloudy,nan
9,0,9,2019-03-15,rain,nan
3012,1430,1582,2019-10-12,partly-cloudy-day,nan
2224,889,1335,2019-07-02,partly-cloudy-day,nan
1687,784,903,2019-01-19,cloudy,nan
26,24,2,2019-04-06,clear-night,nan
2617,1159,1458,2019-03-17,clear-day,St. Patrick's Day
1944,855,1089,2019-07-05,partly-cloudy-day,nan
22,15,7,2019-03-04,cloudy,nan
511,255,256,2019-01-03,partly-cloudy-day,nan
716,342,374,2019-05-05,rain,Cinco de Mayo
0,0,0,2019-01-14,partly-cloudy-night,nan
1619,730,889,2019-07-31,clear-day,nan
1483,624,859,2019-12-05,clear-day,nan
137,73,64,2019-02-26,partly-cloudy-night,nan
802,295,507,2019-03-23,clear-day,nan
685,301,384,2019-05-13,rain,nan
31,12,19,2019-07-02,partly-cloudy-night,nan
0,0,0,2019-08-01,partly-cloudy-night,nan
741,423,318,2019-12-20,clear-day,nan
263,135,128,2019-07-06,partly-cloudy-day,nan
1843,874,969,2019-07-19,partly-cloudy-day,nan
2161,1015,1146,2019-07-07,clear-day,nan
59,26,33,2019-10-27,cloudy,nan
0,0,0,2019-07-29,clear-night,nan
1,0,1,2019-05-31,cloudy,nan
41,26,15,2019-05-29,clear-night,nan
19,13,6,2019-01-04,clear-night,nan
7,6,1,2019-12-01,rain,nan
384,189,195,2019-07-03,partly-cloudy-day,nan
2,1,1,2019-11-28,clear-night,Black Friday
42,21,21,2019-08-17,partly-cloudy-night,nan
0,0,0,2019-03-20,clear-night,nan
1,0,1,2019-11-15,clear-night,nan
1,0,1,2019-12-31,cloudy,New Year's Eve
2,0,2,2019-09-09,partly-cloudy-night,nan
0,0,0,2019-03-16,clear-night,nan
1937,819,1118,2019-10-08,cloudy,nan
183,65,118,2019-04-29,partly-cloudy-night,nan
720,339,381,2019-07-18,cloudy,nan
2349,1037,1312,2019-05-15,partly-cloudy-day,nan
1320,597,723,2019-07-31,partly-cloudy-day,nan
94,0,94,2019-12-10,rain,nan
162,90,72,2019-06-29,partly-cloudy-day,nan
0,0,0,2019-07-08,partly-cloudy-night,nan
1810,820,990,2019-04-10,partly-cloudy-day,nan
30,29,1,2019-11-07,cloudy,nan
6,6,0,2019-12-14,cloudy,nan
2,0,2,2019-06-11,cloudy,nan
300,129,171,2019-09-28,partly-cloudy-day,nan
2920,1199,1721,2019-04-16,clear-day,nan
42,31,11,2019-02-15,cloudy,nan
1,0,1,2019-10-21,rain,nan
2295,1094,1201,2019-12-23,clear-day,nan
2,2,0,2019-12-07,clear-night,nan
5,3,2,2019-08-23,rain,nan
62,61,1,2019-11-09,partly-cloudy-night,nan
442,207,235,2019-10-24,clear-day,nan
5,4,1,2019-01-11,clear-night,nan
236,108,128,2019-02-21,cloudy,nan
60,33,27,2019-06-27,clear-night,nan
1971,975,996,2019-11-09,clear-day,nan
14,10,4,2019-09-23,partly-cloudy-night,nan
857,320,537,2019-10-02,partly-cloudy-day,nan
21,12,9,2019-07-26,clear-night,nan
0,0,0,2019-05-17,clear-night,nan
1,0,1,2019-06-17,cloudy,nan
2445,1034,1411,2019-11-01,clear-day,nan
1855,1059,796,2019-05-16,partly-cloudy-day,nan
1953,920,1033,2019-07-14,partly-cloudy-day,nan
0,0,0,2019-03-18,partly-cloudy-night,nan
0,0,0,2019-11-13,clear-night,nan
0,0,0,2019-11-19,rain,nan
1262,494,768,2019-10-29,fog,nan
0,0,0,2019-07-18,rain,nan
1,0,1,2019-01-02,clear-night,nan
0,0,0,2019-09-23,clear-night,nan
0,0,0,2019-10-29,cloudy,nan
1354,541,813,2019-12-12,clear-day,nan
7,4,3,2019-04-28,partly-cloudy-night,nan
1085,527,558,2019-06-07,partly-cloudy-day,nan
1502,785,717,2019-07-11,partly-cloudy-day,nan
3,0,3,2019-09-06,cloudy,nan
409,174,235,2019-08-30,clear-day,nan
2,0,2,2019-07-04,clear-day,Independence Day
51,49,2,2019-10-18,clear-night,nan
1283,782,501,2019-10-30,cloudy,nan
289,154,135,2019-04-13,cloudy,nan
1452,702,750,2019-03-25,cloudy,nan
1114,649,465,2019-04-01,clear-day,nan
2530,1124,1406,2019-08-25,partly-cloudy-day,nan
54,0,54,2019-12-04,cloudy,nan
0,0,0,2019-08-30,clear-night,nan
1790,807,983,2019-04-03,clear-day,nan
638,319,319,2019-09-11,partly-cloudy-day,nan
3,1,2,2019-01-10,partly-cloudy-night,nan
1483,780,703,2019-07-03,partly-cloudy-day,nan
3,2,1,2019-03-04,snow,nan
593,239,354,2019-09-18,clear-night,nan
22,15,7,2019-05-03,cloudy,nan
1883,848,1035,2019-07-15,clear-day,nan
0,0,0,2019-09-06,partly-cloudy-night,nan
40,17,23,2019-06-25,partly-cloudy-night,nan
1,0,1,2019-04-04,clear-night,nan
1742,722,1020,2019-07-27,clear-day,nan
1,0,1,2019-02-28,clear-night,nan
713,401,312,2019-08-15,partly-cloudy-day,nan
91,84,7,2019-12-16,cloudy,nan
375,155,220,2019-08-08,partly-cloudy-day,nan
36,17,19,2019-01-20,partly-cloudy-night,nan
857,455,402,2019-02-08,partly-cloudy-day,nan
4,0,4,2019-09-08,partly-cloudy-night,nan
0,0,0,2019-10-24,clear-night,nan
1759,1017,742,2019-05-19,partly-cloudy-day,nan
39,38,1,2019-04-20,cloudy,nan
1,1,0,2019-03-23,cloudy,nan
314,135,179,2019-01-21,partly-cloudy-day,Martin Luther King Jr. Day
21,14,7,2019-01-07,partly-cloudy-night,nan
1,0,1,2019-07-03,partly-cloudy-night,nan
67,64,3,2019-10-30,cloudy,Halloween
0,0,0,2019-12-12,clear-night,nan
3,0,3,2019-03-03,partly-cloudy-night,nan
1421,574,847,2019-05-27,clear-day,nan
1571,767,804,2019-11-21,clear-day,nan
0,0,0,2019-12-08,clear-night,nan
129,127,2,2019-05-23,partly-cloudy-night,nan
458,234,224,2019-11-21,clear-day,nan
3,2,1,2019-10-31,rain,Halloween
36,19,17,2019-08-24,partly-cloudy-night,nan
55,0,55,2019-10-13,partly-cloudy-night,nan
4,2,2,2019-02-24,rain,nan
1867,828,1039,2019-09-03,clear-day,nan
594,275,319,2019-02-01,partly-cloudy-day,nan
538,275,263,2019-03-11,clear-day,nan
2605,1402,1203,2019-04-27,clear-day,nan
3,2,1,2019-11-09,clear-night,nan
2459,1218,1241,2019-10-25,partly-cloudy-day,nan
855,476,379,2019-06-30,clear-day,nan
11,7,4,2019-06-11,clear-night,nan
128,62,66,2019-06-15,partly-cloudy-day,nan
50,48,2,2019-04-07,partly-cloudy-night,nan
689,344,345,2019-12-01,rain,nan
11,9,2,2019-07-10,partly-cloudy-night,nan
755,401,354,2019-03-13,clear-day,nan
1,0,1,2019-12-16,clear-night,nan
1174,584,590,2019-03-26,clear-day,nan
3,2,1,2019-11-25,clear-night,nan
166,75,91,2019-05-14,cloudy,nan
437,195,242,2019-09-03,clear-day,nan
1583,722,861,2019-09-17,clear-day,nan
158,79,79,2019-08-19,partly-cloudy-night,nan
0,0,0,2019-02-02,partly-cloudy-night,nan
207,101,106,2019-06-23,clear-night,nan
10,9,1,2019-06-13,rain,nan
359,150,209,2019-07-24,partly-cloudy-day,nan
0,0,0,2019-07-05,partly-cloudy-night,nan
472,262,210,2019-07-31,partly-cloudy-day,nan
0,0,0,2019-11-12,clear-night,nan
1611,909,702,2019-07-10,partly-cloudy-day,nan
1702,851,851,2019-03-29,cloudy,nan
0,0,0,2019-05-09,partly-cloudy-night,nan
10,8,2,2019-08-22,partly-cloudy-night,nan
923,423,500,2019-06-19,cloudy,nan
1499,713,786,2019-03-17,partly-cloudy-day,St. Patrick's Day
143,60,83,2019-10-31,rain,Halloween
541,268,273,2019-01-08,cloudy,nan
231,223,8,2019-12-09,rain,nan
659,408,251,2019-03-02,cloudy,nan
54,52,2,2019-10-05,partly-cloudy-night,nan
131,79,52,2019-11-06,clear-night,nan
1165,683,482,2019-06-17,cloudy,nan
86,82,4,2019-10-26,cloudy,nan
0,0,0,2019-03-29,cloudy,nan
1336,625,711,2019-01-25,partly-cloudy-day,nan
1583,833,750,2019-07-29,clear-day,nan
655,329,326,2019-05-22,clear-day,nan
5,2,3,2019-09-02,partly-cloudy-night,Labor Day
73,52,21,2019-07-28,clear-night,nan
609,351,258,2019-07-22,partly-cloudy-day,nan
1130,663,467,2019-06-27,clear-day,nan
1,0,1,2019-11-01,rain,nan
1,0,1,2019-02-27,cloudy,nan
21,18,3,2019-05-05,rain,nan
1193,624,569,2019-01-19,partly-cloudy-day,nan
8,0,8,2019-10-29,cloudy,nan
286,163,123,2019-12-17,rain,nan
0,0,0,2019-06-05,partly-cloudy-night,nan
481,243,238,2019-03-21,rain,nan
3192,1377,1815,2019-07-05,cloudy,nan
919,431,488,2019-07-11,rain,nan
0,0,0,2019-11-29,partly-cloudy-night,Black Friday
231,114,117,2019-05-18,clear-day,nan
25,22,3,2019-04-26,cloudy,nan
7,6,1,2019-10-29,cloudy,nan
199,72,127,2019-02-13,partly-cloudy-day,nan
349,169,180,2019-10-15,clear-night,nan
0,0,0,2019-02-16,partly-cloudy-night,nan
1517,669,848,2019-05-01,cloudy,nan
831,499,332,2019-10-05,clear-day,nan
27,0,27,2019-03-10,clear-night,Daylight Saving Time starts
3,1,2,2019-06-29,clear-night,nan
228,86,142,2019-01-14,partly-cloudy-day,nan
1367,725,642,2019-12-26,clear-day,nan
75,63,12,2019-04-13,clear-night,nan
11,10,1,2019-06-02,rain,nan
50,37,13,2019-07-17,partly-cloudy-night,nan
40,39,1,2019-12-06,partly-cloudy-night,nan
815,415,400,2019-01-16,cloudy,nan
62,55,7,2019-11-22,partly-cloudy-night,nan
1,0,1,2019-04-05,clear-night,nan
1826,805,1021,2019-06-16,cloudy,Father's Day
0,0,0,2019-11-04,clear-night,nan
1186,601,585,2019-09-25,clear-day,nan
34,28,6,2019-08-11,clear-night,nan
1442,709,733,2019-07-20,partly-cloudy-day,nan
316,170,146,2019-05-12,cloudy,Mother's Day
0,0,0,2019-11-07,clear-night,nan
2211,1269,942,2019-04-21,partly-cloudy-day,Easter Sunday
2,1,1,2019-09-02,partly-cloudy-night,Labor Day
226,116,110,2019-09-29,partly-cloudy-night,nan
1,0,1,2019-10-24,clear-night,nan
1,0,1,2019-03-01,partly-cloudy-night,nan
29,13,16,2019-05-24,clear-night,nan
2,0,2,2019-04-13,cloudy,nan
0,0,0,2019-04-04,clear-night,nan
30,28,2,2019-01-26,partly-cloudy-night,nan
22,17,5,2019-11-29,clear-night,Black Friday
897,416,481,2019-02-25,partly-cloudy-day,nan
83,73,10,2019-01-09,partly-cloudy-night,nan
12,5,7,2019-05-27,clear-night,nan
1,0,1,2019-09-25,clear-night,nan
5,1,4,2019-01-27,partly-cloudy-night,nan
3380,1691,1689,2019-05-25,partly-cloudy-day,nan
200,98,102,2019-06-04,clear-day,nan
2,0,2,2019-11-20,clear-night,nan
91,65,26,2019-06-15,cloudy,Father's Day
50,43,7,2019-09-15,partly-cloudy-night,nan
980,424,556,2019-01-11,clear-day,nan
2612,1171,1441,2019-09-13,partly-cloudy-day,nan
0,0,0,2019-10-09,partly-cloudy-night,nan
2,1,1,2019-05-01,cloudy,nan
97,62,35,2019-09-30,cloudy,nan
0,0,0,2019-03-12,partly-cloudy-night,nan
0,0,0,2019-01-21,partly-cloudy-night,Martin Luther King Jr. Day
271,121,150,2019-11-04,clear-day,nan
270,159,111,2019-02-17,clear-day,nan
20,5,15,2019-07-21,partly-cloudy-night,nan
51,36,15,2019-02-04,clear-night,nan
2857,1227,1630,2019-08-25,partly-cloudy-day,nan
722,383,339,2019-03-19,clear-day,nan
2,1,1,2019-11-11,partly-cloudy-night,Veterans Day
61,59,2,2019-11-23,partly-cloudy-night,nan
1758,765,993,2019-08-20,partly-cloudy-day,nan
1703,959,744,2019-09-05,partly-cloudy-day,nan
191,107,84,2019-05-24,clear-day,nan
1053,392,661,2019-09-15,clear-day,nan
2905,726,2179,2019-09-20,clear-day,nan
2483,1170,1313,2019-06-22,partly-cloudy-day,nan
54,14,40,2019-05-27,clear-night,nan
1432,679,753,2019-03-19,partly-cloudy-day,nan
0,0,0,2019-11-27,clear-night,nan
352,176,176,2019-06-18,rain,nan
1681,1042,639,2019-03-30,partly-cloudy-day,nan
265,155,110,2019-01-05,rain,nan
262,145,117,2019-12-13,rain,nan
0,0,0,2019-07-20,partly-cloudy-day,nan
388,208,180,2019-09-15,partly-cloudy-day,nan
23,21,2,2019-12-03,snow,nan
35,29,6,2019-01-10,partly-cloudy-night,nan
1212,629,583,2019-07-16,partly-cloudy-day,nan
0,0,0,2019-03-18,clear-night,nan
49,17,32,2019-05-31,clear-night,nan
0,0,0,2019-10-18,partly-cloudy-night,nan
18,13,5,2019-05-02,cloudy,nan
2967,1465,1502,2019-06-15,partly-cloudy-day,nan
7,6,1,2019-12-27,partly-cloudy-night,nan
80,51,29,2019-08-30,clear-night,nan
1388,783,605,2019-03-24,clear-day,nan
9,0,9,2019-11-16,clear-night,nan
30,14,16,2019-08-19,partly-cloudy-night,nan
948,560,388,2019-09-04,partly-cloudy-day,nan
1682,859,823,2019-07-29,partly-cloudy-day,nan
68,61,7,2019-11-10,partly-cloudy-night,Veterans Day
1,0,1,2019-01-06,clear-night,nan
385,215,170,2019-01-22,clear-day,nan
1346,617,729,2019-08-03,partly-cloudy-day,nan
182,98,84,2019-09-10,cloudy,nan
6,0,6,2019-02-17,cloudy,nan
0,0,0,2019-12-22,clear-night,nan
0,0,0,2019-02-09,clear-night,nan
2457,1283,1174,2019-04-06,partly-cloudy-day,nan
914,443,471,2019-02-27,partly-cloudy-day,nan
163,88,75,2019-06-22,clear-day,nan
817,412,405,2019-11-19,cloudy,nan
10,0,10,2019-10-13,partly-cloudy-night,nan
229,119,110,2019-10-20,partly-cloudy-night,nan
1687,965,722,2019-08-24,clear-day,nan
229,111,118,2019-02-12,fog,nan
614,286,328,2019-01-15,clear-day,nan
0,0,0,2019-11-01,clear-night,nan
41,23,18,2019-05-20,clear-night,nan
8,4,4,2019-01-24,cloudy,nan
17,16,1,2019-04-04,clear-night,nan
1,0,1,2019-12-27,cloudy,nan
1026,358,668,2019-05-29,cloudy,nan
5,0,5,2019-03-11,clear-night,nan
100,61,39,2019-04-16,partly-cloudy-night,nan
0,0,0,2019-12-01,clear-night,nan
21,11,10,2019-08-30,clear-night,nan
493,191,302,2019-08-10,clear-day,nan
1148,608,540,2019-03-26,clear-day,nan
285,115,170,2019-10-01,cloudy,nan
1101,687,414,2019-09-07,clear-day,nan
10,5,5,2019-07-22,partly-cloudy-night,nan
181,131,50,2019-06-13,rain,nan
2538,1165,1373,2019-03-23,clear-day,nan
2452,1173,1279,2019-04-17,partly-cloudy-day,nan
3,1,2,2019-05-18,clear-night,nan
654,341,313,2019-12-10,rain,nan
1796,852,944,2019-02-03,partly-cloudy-day,nan
2155,945,1210,2019-01-04,clear-day,nan
2167,1135,1032,2019-12-21,partly-cloudy-day,nan
10,6,4,2019-08-02,clear-night,nan
28,17,11,2019-07-19,clear-night,nan
2942,1413,1529,2019-05-18,clear-day,nan
60,59,1,2019-11-12,clear-night,nan
280,136,144,2019-10-12,cloudy,nan
40,18,22,2019-05-09,cloudy,nan
1168,627,541,2019-06-21,rain,nan
0,0,0,2019-08-29,partly-cloudy-night,nan
15,0,15,2019-03-07,clear-night,nan
491,248,243,2019-01-15,clear-night,nan
2976,1413,1563,2019-09-14,cloudy,nan
200,106,94,2019-07-15,clear-day,nan
140,69,71,2019-04-08,cloudy,nan
14,10,4,2019-02-10,clear-night,nan
2377,1111,1266,2019-10-25,partly-cloudy-day,nan
148,73,75,2019-09-26,clear-night,nan
899,533,366,2019-08-16,cloudy,nan
15,12,3,2019-12-20,clear-night,nan
784,392,392,2019-04-26,cloudy,nan
474,210,264,2019-08-12,partly-cloudy-day,nan
284,141,143,2019-07-19,cloudy,nan
79,37,42,2019-05-12,rain,Mother's Day
1209,515,694,2019-07-09,partly-cloudy-day,nan
133,133,0,2019-02-19,clear-day,nan
9,5,4,2019-10-07,rain,nan
0,0,0,2019-08-08,partly-cloudy-night,nan
2013,931,1082,2019-12-08,clear-day,nan
1622,844,778,2019-02-23,clear-day,nan
455,215,240,2019-03-28,clear-day,nan
7,0,7,2019-12-27,clear-night,nan
69,65,4,2019-02-13,clear-night,nan
1,0,1,2019-06-07,clear-night,nan
0,0,0,2019-02-04,clear-night,nan
1252,614,638,2019-07-20,partly-cloudy-day,nan
1475,805,670,2019-06-23,clear-day,nan
1,0,1,2019-11-26,clear-night,nan
1010,526,484,2019-10-01,cloudy,nan
1529,865,664,2019-12-22,clear-day,nan
1669,783,886,2019-09-16,partly-cloudy-day,nan
474,196,278,2019-06-10,cloudy,nan
0,0,0,2019-03-26,cloudy,nan
523,291,232,2019-02-07,cloudy,nan
171,97,74,2019-12-17,rain,nan
4,2,2,2019-01-21,partly-cloudy-night,Martin Luther King Jr. Day
1,0,1,2019-09-01,clear-night,nan
35,22,13,2019-07-30,clear-night,nan
53,43,10,2019-05-22,clear-night,nan
18,16,2,2019-11-05,clear-night,nan
2,1,1,2019-01-26,clear-night,nan
0,0,0,2019-08-21,partly-cloudy-night,nan
726,377,349,2019-04-15,rain,Tax Day
3,1,2,2019-02-10,partly-cloudy-night,nan
18,16,2,2019-02-01,clear-night,nan
232,120,112,2019-12-02,rain,nan
1722,775,947,2019-05-04,cloudy,nan
1450,808,642,2019-07-30,partly-cloudy-day,nan
0,0,0,2019-11-18,cloudy,nan
1,0,1,2019-01-07,clear-night,nan
421,212,209,2019-03-18,partly-cloudy-day,nan
348,137,211,2019-11-08,clear-day,nan
485,241,244,2019-10-02,partly-cloudy-day,nan
0,0,0,2019-06-16,cloudy,Father's Day
2,1,1,2019-09-05,clear-night,nan
1005,524,481,2019-03-27,clear-day,nan
1629,665,964,2019-07-16,partly-cloudy-day,nan
1999,971,1028,2019-10-11,cloudy,nan
1361,600,761,2019-12-18,partly-cloudy-day,nan
18,0,18,2019-07-17,rain,nan
1106,466,640,2019-02-18,partly-cloudy-day,Presidents' Day (regional holiday)
0,0,0,2019-08-28,partly-cloudy-night,nan
67,63,4,2019-12-11,partly-cloudy-night,nan
838,379,459,2019-01-17,partly-cloudy-day,nan
496,246,250,2019-01-29,cloudy,nan
0,0,0,2019-07-14,clear-night,nan
1192,533,659,2019-04-09,cloudy,nan
1948,838,1110,2019-04-12,partly-cloudy-day,nan
0,0,0,2019-10-21,cloudy,nan
458,232,226,2019-05-28,partly-cloudy-day,nan
86,42,44,2019-03-22,rain,nan
4,0,4,2019-10-05,clear-night,nan
2116,904,1212,2019-08-29,partly-cloudy-day,nan
222,135,87,2019-09-26,cloudy,nan
271,122,149,2019-10-04,partly-cloudy-day,nan
307,162,145,2019-11-30,clear-day,nan
7,3,4,2019-06-18,rain,nan
507,247,260,2019-05-08,clear-night,nan
0,0,0,2019-12-25,clear-night,Christmas Day
212,94,118,2019-06-26,partly-cloudy-day,nan
305,167,138,2019-02-27,partly-cloudy-day,nan
1,0,1,2019-08-16,partly-cloudy-night,nan
2,1,1,2019-08-12,clear-night,nan
0,0,0,2019-01-12,partly-cloudy-day,nan
896,476,420,2019-12-30,rain,nan
2129,949,1180,2019-07-25,partly-cloudy-day,nan
1,0,1,2019-06-18,cloudy,nan
6,0,6,2019-04-20,rain,nan
1038,564,474,2019-11-27,partly-cloudy-day,nan
0,0,0,2019-04-29,clear-night,nan
0,0,0,2019-11-14,clear-night,nan
0,0,0,2019-08-14,partly-cloudy-night,nan
8,5,3,2019-05-13,cloudy,nan
0,0,0,2019-08-13,cloudy,nan
38,20,18,2019-12-24,clear-night,Christmas Eve
905,529,376,2019-06-05,partly-cloudy-day,nan
2,2,0,2019-04-06,cloudy,nan
2445,1055,1390,2019-10-06,cloudy,nan
1505,775,730,2019-07-21,partly-cloudy-day,nan
13,9,4,2019-04-30,rain,nan
0,0,0,2019-12-11,rain,nan
2088,877,1211,2019-08-06,partly-cloudy-day,nan
0,0,0,2019-08-06,partly-cloudy-night,nan
0,0,0,2019-12-19,clear-night,nan
489,247,242,2019-02-20,snow,nan
2128,1034,1094,2019-01-03,partly-cloudy-day,nan
885,513,372,2019-01-27,clear-day,nan
209,94,115,2019-10-09,cloudy,nan
0,0,0,2019-03-21,partly-cloudy-night,nan
0,0,0,2019-08-24,partly-cloudy-night,nan
854,377,477,2019-02-06,partly-cloudy-day,nan
14,13,1,2019-01-29,rain,nan
695,383,312,2019-10-10,partly-cloudy-day,nan
17,15,2,2019-12-24,clear-night,Christmas Eve
428,198,230,2019-08-01,partly-cloudy-day,nan
91,52,39,2019-04-02,clear-night,nan
1909,828,1081,2019-11-04,clear-day,nan
1478,747,731,2019-05-23,partly-cloudy-day,nan
8,3,5,2019-10-08,partly-cloudy-night,nan
67,40,27,2019-11-22,cloudy,nan
379,161,218,2019-01-31,clear-day,nan
1156,545,611,2019-09-12,cloudy,nan
0,0,0,2019-01-10,cloudy,nan
5,0,5,2019-08-12,partly-cloudy-night,nan
273,114,159,2019-08-13,cloudy,nan
1873,939,934,2019-06-04,partly-cloudy-day,nan
20,6,14,2019-03-02,snow,nan
2076,1248,828,2019-08-12,clear-day,nan
2532,1147,1385,2019-04-14,partly-cloudy-day,nan
0,0,0,2019-01-13,cloudy,nan
2020,932,1088,2019-08-01,partly-cloudy-day,nan
2575,1222,1353,2019-09-28,partly-cloudy-day,nan
7,3,4,2019-02-09,clear-night,nan
69,64,5,2019-10-19,clear-night,nan
2,0,2,2019-05-27,clear-night,Memorial Day
2021,915,1106,2019-06-03,partly-cloudy-day,nan
0,0,0,2019-12-13,clear-night,nan
0,0,0,2019-02-06,clear-night,nan
465,245,220,2019-08-24,partly-cloudy-day,nan
1571,665,906,2019-03-20,clear-day,nan
1,0,1,2019-12-17,rain,nan
1639,760,879,2019-10-17,cloudy,nan
0,0,0,2019-12-06,clear-night,nan
3007,1268,1739,2019-11-02,partly-cloudy-day,nan
2620,1071,1549,2019-07-07,partly-cloudy-day,nan
1841,864,977,2019-11-27,cloudy,nan
2096,1006,1090,2019-08-29,clear-day,nan
3114,1404,1710,2019-06-08,partly-cloudy-day,nan
0,0,0,2019-04-16,clear-night,nan
18,12,6,2019-03-16,partly-cloudy-night,nan
1427,589,838,2019-02-14,partly-cloudy-day,Valentine's Day
1970,901,1069,2019-05-07,partly-cloudy-day,nan
1860,989,871,2019-04-16,clear-day,nan
16,11,5,2019-01-19,cloudy,nan
1487,646,841,2019-07-01,partly-cloudy-day,nan
2467,1128,1339,2019-02-16,clear-day,nan
1607,721,886,2019-01-06,partly-cloudy-day,nan
1918,831,1087,2019-11-26,clear-day,nan
0,0,0,2019-09-17,clear-night,nan
2655,1196,1459,2019-03-09,clear-day,nan
111,48,63,2019-06-20,rain,nan
49,0,49,2019-04-12,cloudy,nan
0,0,0,2019-02-02,clear-night,nan
2038,1033,1005,2019-09-22,clear-day,nan
140,104,36,2019-04-09,rain,nan
4,3,1,2019-05-05,rain,Cinco de Mayo
4,2,2,2019-02-28,cloudy,nan
1,0,1,2019-07-28,partly-cloudy-night,nan
2354,1198,1156,2019-08-09,partly-cloudy-day,nan
47,0,47,2019-10-16,rain,nan
815,280,535,2019-04-26,cloudy,nan
2707,1185,1522,2019-09-28,partly-cloudy-day,nan
149,77,72,2019-05-12,rain,Mother's Day
1648,732,916,2019-11-15,clear-day,nan
812,362,450,2019-01-17,partly-cloudy-day,nan
3008,1305,1703,2019-08-11,partly-cloudy-day,nan
1263,517,746,2019-08-07,partly-cloudy-day,nan
1287,597,690,2019-03-05,clear-day,nan
2905,1351,1554,2019-08-10,partly-cloudy-day,nan
1847,917,930,2019-06-29,partly-cloudy-day,nan
10,9,1,2019-12-14,cloudy,nan
0,0,0,2019-06-03,partly-cloudy-night,nan
413,247,166,2019-11-28,cloudy,Thanksgiving Day
3411,1558,1853,2019-09-01,partly-cloudy-day,nan
0,0,0,2019-03-31,clear-night,nan
46,45,1,2019-12-28,clear-night,nan
543,271,272,2019-10-27,partly-cloudy-night,nan
334,179,155,2019-01-04,clear-night,nan
112,54,58,2019-02-26,clear-day,nan
0,0,0,2019-07-25,partly-cloudy-night,nan
1850,908,942,2019-01-06,partly-cloudy-day,nan
1040,615,425,2019-08-04,partly-cloudy-day,nan
744,351,393,2019-01-28,clear-day,nan
1901,1004,897,2019-09-03,partly-cloudy-day,nan
0,0,0,2019-10-10,partly-cloudy-night,nan
61,39,22,2019-10-07,cloudy,nan
2,0,2,2019-07-21,clear-night,nan
3,2,1,2019-10-13,cloudy,nan
0,0,0,2019-12-29,clear-night,nan
181,78,103,2019-06-18,cloudy,nan
2,1,1,2019-05-21,clear-night,nan
840,484,356,2019-03-25,cloudy,nan
0,0,0,2019-10-07,cloudy,nan
1037,513,524,2019-02-11,cloudy,nan
1676,827,849,2019-06-06,partly-cloudy-day,nan
536,276,260,2019-12-19,clear-day,nan
6,3,3,2019-07-09,clear-night,nan
1562,843,719,2019-06-14,partly-cloudy-day,nan
1,0,1,2019-05-16,cloudy,nan
92,70,22,2019-09-08,partly-cloudy-night,nan
7,0,7,2019-04-28,clear-night,nan
1106,557,549,2019-04-04,clear-day,nan
3,1,2,2019-01-18,cloudy,nan
0,0,0,2019-02-26,clear-night,nan
2676,1153,1523,2019-10-28,partly-cloudy-day,nan
2151,1015,1136,2019-12-07,clear-day,nan
0,0,0,2019-02-11,cloudy,nan
3346,1453,1893,2019-04-27,partly-cloudy-day,nan
93,30,63,2019-04-06,cloudy,nan
103,43,60,2019-06-18,cloudy,nan
114,110,4,2019-04-20,partly-cloudy-night,Easter Sunday
2859,1191,1668,2019-05-19,clear-day,nan
895,464,431,2019-03-01,cloudy,nan
67,18,49,2019-07-15,clear-night,nan
2563,1269,1294,2019-08-17,partly-cloudy-day,nan
21,15,6,2019-01-05,partly-cloudy-night,nan
1908,873,1035,2019-03-29,cloudy,nan
2648,1179,1469,2019-04-25,partly-cloudy-day,nan
0,0,0,2019-01-11,partly-cloudy-night,nan
1205,511,694,2019-02-28,clear-day,nan
2735,1167,1568,2019-11-02,partly-cloudy-day,nan
1373,738,635,2019-05-15,clear-day,nan
2245,1211,1034,2019-07-13,partly-cloudy-day,nan
5,4,1,2019-03-22,partly-cloudy-night,nan
0,0,0,2019-01-18,partly-cloudy-night,nan
7,7,0,2019-02-20,clear-night,nan
2989,1323,1666,2019-09-21,clear-day,nan
440,201,239,2019-04-27,clear-night,nan
2337,1222,1115,2019-05-04,cloudy,nan
39,20,19,2019-01-01,rain,New Year's Day
1,0,1,2019-08-25,partly-cloudy-night,nan
40,39,1,2019-12-18,partly-cloudy-night,nan
1862,931,931,2019-08-23,partly-cloudy-day,nan
173,90,83,2019-07-08,rain,nan
1,0,1,2019-11-23,clear-night,nan
1449,633,816,2019-03-08,partly-cloudy-day,nan
5,0,5,2019-08-03,clear-night,nan
467,230,237,2019-10-03,rain,nan
2657,1454,1203,2019-09-14,cloudy,nan
0,0,0,2019-07-16,clear-night,nan
51,20,31,2019-06-11,rain,nan
565,301,264,2019-12-23,clear-day,nan
1884,843,1041,2019-05-30,cloudy,nan
4,2,2,2019-02-16,partly-cloudy-night,nan
1817,891,926,2019-07-02,clear-day,nan
503,235,268,2019-07-23,cloudy,nan
1220,650,570,2019-03-12,partly-cloudy-day,nan
13,12,1,2019-10-21,clear-night,nan
2647,1136,1511,2019-11-09,clear-day,nan
128,76,52,2019-02-21,clear-night,nan
2,0,2,2019-01-12,clear-night,nan
262,122,140,2019-05-29,partly-cloudy-day,nan
512,246,266,2019-02-05,partly-cloudy-day,nan
2142,1168,974,2019-08-31,partly-cloudy-day,nan
1425,615,810,2019-06-28,partly-cloudy-day,nan
188,89,99,2019-05-31,clear-day,nan
104,55,49,2019-11-17,cloudy,nan
282,94,188,2019-05-14,rain,nan
0,0,0,2019-12-04,cloudy,nan
2033,1044,989,2019-04-10,partly-cloudy-day,nan
1020,474,546,2019-03-31,partly-cloudy-day,nan
2873,1320,1553,2019-08-31,partly-cloudy-day,nan
252,100,152,2019-09-12,partly-cloudy-day,nan
1818,1059,759,2019-06-12,partly-cloudy-day,nan
486,286,200,2019-03-05,clear-day,nan
1,0,1,2019-07-11,partly-cloudy-night,nan
21,18,3,2019-11-07,rain,nan
202,82,120,2019-11-20,partly-cloudy-day,nan
23,21,2,2019-08-11,clear-night,nan
0,0,0,2019-11-20,clear-night,nan
40,23,17,2019-10-10,cloudy,nan
703,407,296,2019-12-15,clear-day,nan
1523,752,771,2019-07-12,clear-day,nan
0,0,0,2019-01-22,clear-night,nan
795,404,391,2019-06-25,cloudy,nan
779,509,270,2019-11-03,clear-day,Daylight Saving Time ends
35,34,1,2019-11-18,cloudy,nan
8,2,6,2019-01-22,partly-cloudy-night,nan
0,0,0,2019-01-14,nan,nan
105,43,62,2019-12-01,rain,nan
1,0,1,2019-01-04,clear-night,nan
2771,1288,1483,2019-05-26,clear-day,nan
167,74,93,2019-04-24,clear-night,nan
0,0,0,2019-05-22,clear-night,nan
493,289,204,2019-09-06,rain,nan
10,5,5,2019-04-02,cloudy,nan
1200,638,562,2019-09-16,cloudy,nan
1280,584,696,2019-03-12,partly-cloudy-day,nan
426,201,225,2019-05-13,cloudy,nan
1061,497,564,2019-01-09,cloudy,nan
65,56,9,2019-10-13,cloudy,nan
1953,1032,921,2019-07-06,partly-cloudy-day,nan
2344,1365,979,2019-04-18,partly-cloudy-day,nan
32,14,18,2019-05-05,rain,Cinco de Mayo
0,0,0,2019-05-01,cloudy,nan
941,400,541,2019-10-26,partly-cloudy-night,nan
135,82,53,2019-03-24,clear-day,nan
0,0,0,2019-06-20,cloudy,nan
783,474,309,2019-11-25,partly-cloudy-day,nan
1940,778,1162,2019-07-06,rain,nan
264,96,168,2019-12-12,clear-day,nan
680,375,305,2019-11-01,clear-day,nan
4,2,2,2019-10-29,cloudy,nan
157,81,76,2019-05-27,clear-day,Memorial Day
512,316,196,2019-06-19,cloudy,nan
214,92,122,2019-08-26,cloudy,nan
0,0,0,2019-03-07,partly-cloudy-night,nan
1,0,1,2019-12-31,cloudy,New Year's Eve
1487,712,775,2019-11-05,partly-cloudy-day,nan
2059,1095,964,2019-09-27,clear-day,nan
2,0,2,2019-04-26,cloudy,nan
12,0,12,2019-12-17,cloudy,nan
1843,987,856,2019-05-21,clear-day,nan
2149,1171,978,2019-08-09,partly-cloudy-day,nan
1559,659,900,2019-03-19,partly-cloudy-day,nan
1,0,1,2019-12-22,clear-night,nan
1051,545,506,2019-12-05,partly-cloudy-day,nan
0,0,0,2019-05-24,clear-night,nan
155,57,98,2019-11-28,partly-cloudy-night,Thanksgiving Day
1903,1039,864,2019-09-19,clear-day,nan
1380,664,716,2019-07-15,clear-day,nan
3405,1820,1585,2019-12-31,partly-cloudy-day,New Year's Eve
2,2,0,2019-05-04,rain,nan
26,17,9,2019-01-13,partly-cloudy-night,nan
159,116,43,2019-11-16,clear-night,nan
11,0,11,2019-03-10,cloudy,Daylight Saving Time starts
1,1,0,2019-11-02,clear-night,nan
63,53,10,2019-02-14,clear-night,Valentine's Day
10,0,10,2019-11-16,clear-night,nan
12,8,4,2019-03-08,partly-cloudy-night,nan
1756,836,920,2019-06-12,partly-cloudy-day,nan
4,3,1,2019-10-27,partly-cloudy-night,nan
1455,701,754,2019-05-02,partly-cloudy-day,nan
2761,1124,1637,2019-08-04,partly-cloudy-day,nan
45,26,19,2019-05-12,rain,Mother's Day
526,279,247,2019-09-06,partly-cloudy-day,nan
1469,770,699,2019-12-21,clear-day,nan
385,161,224,2019-03-25,cloudy,nan
1,0,1,2019-05-10,cloudy,nan
50,29,21,2019-07-22,clear-night,nan
7,0,7,2019-10-25,clear-night,nan
160,76,84,2019-05-30,cloudy,nan
3,1,2,2019-01-13,cloudy,nan
3628,1476,2152,2019-10-13,partly-cloudy-day,nan
2131,959,1172,2019-05-15,partly-cloudy-day,nan
10,9,1,2019-10-30,cloudy,nan
2520,1196,1324,2019-05-06,clear-day,nan
55,52,3,2019-11-10,partly-cloudy-night,Veterans Day
72,39,33,2019-02-20,clear-night,nan
299,156,143,2019-01-10,partly-cloudy-night,nan
26,18,8,2019-01-19,cloudy,nan
20,17,3,2019-01-01,partly-cloudy-night,New Year's Day
262,181,81,2019-07-11,rain,nan
2,0,2,2019-11-10,partly-cloudy-night,Veterans Day
2,0,2,2019-09-30,partly-cloudy-night,nan
1005,563,442,2019-12-07,clear-day,nan
1441,621,820,2019-12-20,clear-day,nan
132,48,84,2019-02-08,rain,nan
5,3,2,2019-11-24,cloudy,nan
203,77,126,2019-01-11,clear-day,nan
522,284,238,2019-06-10,rain,nan
159,82,77,2019-08-14,cloudy,nan
76,43,33,2019-08-03,partly-cloudy-night,nan
1350,543,807,2019-07-28,partly-cloudy-day,nan
2071,962,1109,2019-01-03,partly-cloudy-day,nan
835,473,362,2019-10-09,cloudy,nan
64,33,31,2019-01-16,partly-cloudy-night,nan
2223,1077,1146,2019-05-24,partly-cloudy-day,nan
30,16,14,2019-05-26,partly-cloudy-night,Memorial Day
19,9,10,2019-06-24,partly-cloudy-night,nan
1,1,0,2019-05-25,partly-cloudy-night,nan
1130,493,637,2019-09-02,partly-cloudy-day,Labor Day
15,8,7,2019-01-05,clear-night,nan
117,57,60,2019-01-22,clear-day,nan
425,159,266,2019-10-01,cloudy,nan
1354,614,740,2019-06-25,partly-cloudy-day,nan
12,8,4,2019-08-29,clear-night,nan
46,34,12,2019-02-09,clear-night,nan
111,60,51,2019-01-19,partly-cloudy-night,nan
114,96,18,2019-07-23,cloudy,nan
0,0,0,2019-06-30,partly-cloudy-night,nan
1764,698,1066,2019-05-30,partly-cloudy-day,nan
104,46,58,2019-05-02,cloudy,nan
0,0,0,2019-11-21,clear-night,nan
3150,1447,1703,2019-05-18,clear-day,nan
12,7,5,2019-04-02,partly-cloudy-night,nan
0,0,0,2019-10-27,partly-cloudy-night,nan
3722,1972,1750,2019-12-27,cloudy,nan
100,67,33,2019-11-08,clear-night,nan
3185,1519,1666,2019-05-18,clear-day,nan
2077,1138,939,2019-07-26,partly-cloudy-day,nan
1,0,1,2019-07-18,rain,nan
1158,661,497,2019-08-19,partly-cloudy-day,nan
1908,902,1006,2019-12-08,clear-day,nan
2822,1221,1601,2019-09-15,partly-cloudy-day,nan
56,32,24,2019-07-11,partly-cloudy-night,nan
7,2,5,2019-12-26,cloudy,nan
9,4,5,2019-09-24,partly-cloudy-night,nan
37,22,15,2019-01-29,partly-cloudy-night,nan
76,52,24,2019-09-08,cloudy,nan
1961,925,1036,2019-07-03,partly-cloudy-day,nan
120,46,74,2019-07-12,clear-night,nan
5,4,1,2019-04-14,partly-cloudy-night,nan
0,0,0,2019-12-02,rain,nan
1143,439,704,2019-08-28,cloudy,nan
2,0,2,2019-09-28,clear-night,nan
0,0,0,2019-01-12,clear-night,nan
3,0,3,2019-01-23,clear-night,nan
1715,643,1072,2019-05-29,cloudy,nan
949,361,588,2019-10-20,rain,nan
1022,489,533,2019-03-12,partly-cloudy-day,nan
70,69,1,2019-12-12,clear-night,nan
2672,1099,1573,2019-09-08,partly-cloudy-day,nan
0,0,0,2019-11-05,partly-cloudy-night,nan
107,54,53,2019-04-18,partly-cloudy-night,nan
1672,674,998,2019-07-23,cloudy,nan
7,3,4,2019-03-01,cloudy,nan
901,398,503,2019-10-31,cloudy,Halloween
267,131,136,2019-09-01,partly-cloudy-day,nan
0,0,0,2019-12-10,rain,nan
1240,590,650,2019-11-19,cloudy,nan
3,2,1,2019-06-05,partly-cloudy-night,nan
30,0,30,2019-12-15,partly-cloudy-night,nan
1674,885,789,2019-08-14,partly-cloudy-day,nan
829,341,488,2019-01-28,clear-day,nan
134,130,4,2019-01-23,cloudy,nan
14,13,1,2019-11-18,rain,nan
1540,733,807,2019-10-08,partly-cloudy-day,nan
1259,511,748,2019-12-03,clear-day,nan
1079,460,619,2019-12-10,cloudy,nan
0,0,0,2019-02-03,clear-night,nan
21,12,9,2019-06-16,partly-cloudy-night,Father's Day
2,1,1,2019-05-13,cloudy,nan
421,187,234,2019-09-20,clear-day,nan
2631,1137,1494,2019-07-06,partly-cloudy-day,nan
2,1,1,2019-05-17,partly-cloudy-night,nan
1713,715,998,2019-11-11,clear-day,Veterans Day
11,10,1,2019-09-09,partly-cloudy-night,nan
89,53,36,2019-04-21,cloudy,Easter Sunday
1080,566,514,2019-02-08,partly-cloudy-day,nan
418,189,229,2019-06-10,cloudy,nan
496,209,287,2019-11-22,rain,nan
2263,1050,1213,2019-01-04,partly-cloudy-day,nan
321,166,155,2019-02-24,cloudy,nan
276,123,153,2019-01-09,clear-day,nan
1740,921,819,2019-07-08,partly-cloudy-day,nan
2239,1081,1158,2019-12-15,partly-cloudy-day,nan
0,0,0,2019-10-21,partly-cloudy-night,nan
2,0,2,2019-07-29,partly-cloudy-night,nan
0,0,0,2019-05-28,clear-night,nan
0,0,0,2019-12-16,partly-cloudy-night,nan
46,46,0,2019-02-19,clear-night,nan
2510,1311,1199,2019-06-01,clear-day,nan
2267,1152,1115,2019-08-15,partly-cloudy-day,nan
2379,1161,1218,2019-10-06,cloudy,nan
1191,494,697,2019-04-09,cloudy,nan
0,0,0,2019-04-01,clear-night,nan
2497,1030,1467,2019-08-15,partly-cloudy-day,nan
0,0,0,2019-02-18,cloudy,Presidents' Day (regional holiday)
346,162,184,2019-02-01,partly-cloudy-day,nan
819,400,419,2019-09-13,partly-cloudy-day,nan
2529,1225,1304,2019-10-28,cloudy,nan
617,324,293,2019-08-26,partly-cloudy-day,nan
165,101,64,2019-05-13,rain,nan
1912,891,1021,2019-09-10,partly-cloudy-day,nan
259,135,124,2019-08-04,partly-cloudy-day,nan
221,143,78,2019-11-24,rain,nan
921,550,371,2019-09-10,cloudy,nan
75,55,20,2019-03-30,cloudy,nan
1030,399,631,2019-10-02,clear-day,nan
24,0,24,2019-12-17,rain,nan
154,96,58,2019-09-06,rain,nan
80,69,11,2019-02-03,partly-cloudy-night,nan
1942,829,1113,2019-11-25,clear-day,nan
0,0,0,2019-08-20,clear-night,nan
189,76,113,2019-07-31,clear-day,nan
127,53,74,2019-02-25,clear-night,nan
208,83,125,2019-08-03,partly-cloudy-day,nan
1085,607,478,2019-09-18,partly-cloudy-day,nan
119,60,59,2019-07-09,clear-night,nan
1314,619,695,2019-11-27,cloudy,nan
19,17,2,2019-12-16,cloudy,nan
1901,890,1011,2019-08-09,clear-day,nan
1732,999,733,2019-07-29,partly-cloudy-day,nan
2380,1115,1265,2019-10-20,cloudy,nan
15,13,2,2019-12-25,clear-night,nan
46,17,29,2019-01-16,partly-cloudy-night,nan
1819,952,867,2019-06-16,partly-cloudy-day,Father's Day
188,82,106,2019-03-27,clear-day,nan
1796,1058,738,2019-08-20,partly-cloudy-day,nan
44,32,12,2019-08-02,partly-cloudy-night,nan
2119,851,1268,2019-11-03,partly-cloudy-day,Daylight Saving Time ends
100,42,58,2019-05-19,partly-cloudy-day,nan
0,0,0,2019-09-24,partly-cloudy-night,nan
15,14,1,2019-10-30,cloudy,Halloween
56,39,17,2019-03-03,partly-cloudy-night,nan
0,0,0,2019-11-10,partly-cloudy-night,nan
52,37,15,2019-03-21,rain,nan
0,0,0,2019-03-13,clear-night,nan
126,76,50,2019-10-01,clear-night,nan
0,0,0,2019-03-29,partly-cloudy-night,nan
288,164,124,2019-11-05,clear-night,nan
568,325,243,2019-11-15,clear-day,nan
3061,1502,1559,2019-08-17,partly-cloudy-day,nan
0,0,0,2019-10-14,cloudy,Columbus Day (regional holiday)
114,53,61,2019-03-16,partly-cloudy-night,nan
564,248,316,2019-08-14,cloudy,nan
398,220,178,2019-06-19,cloudy,nan
0,0,0,2019-07-02,clear-night,nan
2,1,1,2019-04-25,clear-night,nan
0,0,0,2019-01-10,cloudy,nan
26,14,12,2019-01-16,clear-night,nan
1115,500,615,2019-02-24,cloudy,nan
22,10,12,2019-01-23,clear-night,nan
80,77,3,2019-10-19,clear-night,nan
138,89,49,2019-09-02,partly-cloudy-night,Labor Day
7,0,7,2019-06-06,clear-night,nan
634,304,330,2019-09-20,clear-night,nan
0,0,0,2019-04-04,clear-night,nan
3332,1412,1920,2019-04-06,clear-day,nan
1574,815,759,2019-07-10,partly-cloudy-day,nan
0,0,0,2019-04-07,clear-night,nan
172,84,88,2019-05-08,cloudy,nan
0,0,0,2019-04-21,partly-cloudy-night,Easter Sunday
2392,1081,1311,2019-07-24,partly-cloudy-day,nan
6,4,2,2019-10-14,clear-night,nan
2548,1323,1225,2019-12-26,partly-cloudy-day,nan
58,56,2,2019-08-18,clear-night,nan
179,88,91,2019-12-20,clear-day,nan
3,2,1,2019-01-05,cloudy,nan
3,2,1,2019-10-08,partly-cloudy-night,nan
71,0,71,2019-12-10,cloudy,nan
15,14,1,2019-10-22,rain,nan
402,163,239,2019-08-19,partly-cloudy-night,nan
447,188,259,2019-03-28,clear-day,nan
1051,517,534,2019-02-14,clear-day,Valentine's Day
7,2,5,2019-06-17,partly-cloudy-night,nan
277,102,175,2019-03-14,partly-cloudy-day,nan
915,433,482,2019-06-20,rain,nan
1,0,1,2019-04-15,cloudy,Tax Day
5,3,2,2019-04-20,rain,nan
2040,934,1106,2019-06-29,partly-cloudy-day,nan
124,71,53,2019-04-27,partly-cloudy-night,nan
338,160,178,2019-04-21,partly-cloudy-night,Easter Monday
0,0,0,2019-06-19,cloudy,nan
1850,864,986,2019-03-15,partly-cloudy-day,nan
1,0,1,2019-05-02,fog,nan
112,110,2,2019-01-30,partly-cloudy-night,nan
132,75,57,2019-08-11,clear-night,nan
3,2,1,2019-03-19,clear-night,nan
1,0,1,2019-12-28,clear-night,nan
114,61,53,2019-04-10,clear-night,nan
1047,547,500,2019-09-26,partly-cloudy-day,nan
11,10,1,2019-03-27,clear-night,nan
14,13,1,2019-05-28,rain,nan
1711,773,938,2019-06-23,clear-day,nan
368,150,218,2019-04-26,rain,nan
51,47,4,2019-11-30,clear-night,nan
2,0,2,2019-08-09,partly-cloudy-night,nan
204,88,116,2019-07-28,clear-day,nan
267,97,170,2019-03-25,partly-cloudy-day,nan
0,0,0,2019-03-10,rain,Daylight Saving Time starts
413,180,233,2019-09-27,clear-day,nan
1385,732,653,2019-08-02,partly-cloudy-day,nan
602,345,257,2019-05-23,cloudy,nan
3,0,3,2019-10-25,clear-night,nan
51,42,9,2019-07-25,partly-cloudy-night,nan
95,72,23,2019-09-11,partly-cloudy-night,nan
7,7,0,2019-12-29,rain,nan
38,27,11,2019-10-24,clear-night,nan
1,1,0,2019-06-08,partly-cloudy-night,nan
821,363,458,2019-02-13,cloudy,nan
0,0,0,2019-03-14,cloudy,nan
25,13,12,2019-02-03,clear-night,nan
52,30,22,2019-11-19,cloudy,nan
2197,989,1208,2019-05-07,clear-day,nan
1,0,1,2019-02-14,cloudy,Valentine's Day
260,118,142,2019-06-03,clear-day,nan
389,131,258,2019-09-16,cloudy,nan
1236,621,615,2019-02-18,cloudy,Presidents' Day (regional holiday)
5,3,2,2019-12-05,cloudy,nan
1973,1081,892,2019-12-21,partly-cloudy-day,nan
0,0,0,2019-02-23,clear-night,nan
1602,671,931,2019-04-12,partly-cloudy-day,nan
17,11,6,2019-08-05,clear-night,nan
948,545,403,2019-04-22,partly-cloudy-day,Easter Monday
1,0,1,2019-11-19,rain,nan
0,0,0,2019-10-05,clear-night,nan
4,4,0,2019-11-06,clear-night,nan
606,386,220,2019-07-30,clear-day,nan
24,17,7,2019-04-18,partly-cloudy-night,nan
3,2,1,2019-01-14,clear-night,nan
1449,704,745,2019-06-05,partly-cloudy-day,nan
2806,1333,1473,2019-04-23,partly-cloudy-day,nan
1787,992,795,2019-07-24,partly-cloudy-day,nan
294,137,157,2019-04-05,partly-cloudy-day,nan
779,406,373,2019-12-14,cloudy,nan
515,268,247,2019-04-11,cloudy,nan
30,27,3,2019-02-27,cloudy,nan
0,0,0,2019-03-21,cloudy,nan
217,118,99,2019-03-13,partly-cloudy-night,nan
2499,1194,1305,2019-10-04,partly-cloudy-day,nan
60,59,1,2019-02-07,cloudy,nan
103,83,20,2019-05-16,clear-night,nan
6,5,1,2019-02-09,clear-night,nan
21,21,0,2019-02-20,rain,nan
425,159,266,2019-07-16,clear-day,nan
27,19,8,2019-02-07,cloudy,nan
263,119,144,2019-09-22,clear-day,nan
3,2,1,2019-07-06,partly-cloudy-night,nan
0,0,0,2019-02-01,clear-night,nan
0,0,0,2019-09-13,partly-cloudy-night,nan
1,0,1,2019-12-09,cloudy,nan
1630,804,826,2019-08-22,partly-cloudy-day,nan
13,6,7,2019-08-27,clear-night,nan
1025,558,467,2019-02-15,cloudy,nan
1880,1033,847,2019-10-21,clear-day,nan
316,120,196,2019-09-11,partly-cloudy-day,nan
185,72,113,2019-12-11,cloudy,nan
1298,671,627,2019-04-19,partly-cloudy-day,nan
2169,1161,1008,2019-06-09,clear-day,nan
2,0,2,2019-09-13,cloudy,nan
691,377,314,2019-10-15,clear-day,nan
0,0,0,2019-04-12,cloudy,nan
2160,949,1211,2019-08-23,partly-cloudy-day,nan
2168,1001,1167,2019-06-04,partly-cloudy-day,nan
4,0,4,2019-11-29,clear-night,nan
80,64,16,2019-04-24,clear-night,nan
342,173,169,2019-02-04,clear-day,nan
168,96,72,2019-08-25,partly-cloudy-night,nan
194,76,118,2019-12-07,clear-night,nan
1,0,1,2019-11-24,clear-night,nan
0,0,0,2019-02-25,clear-night,nan
430,172,258,2019-06-17,partly-cloudy-day,nan
2591,1129,1462,2019-04-17,clear-day,nan
3,2,1,2019-11-17,cloudy,nan
44,31,13,2019-04-27,clear-night,nan
2809,1218,1591,2019-09-21,clear-day,nan
2891,1388,1503,2019-06-15,partly-cloudy-day,nan
12,6,6,2019-09-30,cloudy,nan
0,0,0,2019-10-12,cloudy,nan
1735,874,861,2019-04-04,clear-day,nan
346,145,201,2019-09-18,partly-cloudy-day,nan
185,107,78,2019-02-12,fog,nan
0,0,0,2019-05-31,partly-cloudy-night,nan
23,13,10,2019-09-08,partly-cloudy-night,nan
0,0,0,2019-02-02,clear-day,nan
0,0,0,2019-12-04,partly-cloudy-night,nan
1,0,1,2019-10-03,rain,nan
668,371,297,2019-02-13,clear-day,nan
1639,752,887,2019-02-09,clear-day,nan
49,37,12,2019-04-16,partly-cloudy-night,nan
136,68,68,2019-03-05,clear-day,nan
0,0,0,2019-04-19,partly-cloudy-night,nan
0,0,0,2019-06-11,cloudy,nan
17,0,17,2019-12-14,rain,nan
76,54,22,2019-07-03,clear-night,nan
1607,842,765,2019-07-28,clear-day,nan
0,0,0,2019-12-20,partly-cloudy-night,nan
0,0,0,2019-11-23,clear-night,nan
386,231,155,2019-11-03,clear-day,Daylight Saving Time ends
1,0,1,2019-07-25,partly-cloudy-night,nan
1010,468,542,2019-02-26,partly-cloudy-day,nan
44,42,2,2019-03-07,clear-night,nan
443,172,271,2019-09-09,partly-cloudy-day,nan
0,0,0,2019-11-20,partly-cloudy-night,nan
12,0,12,2019-04-05,rain,nan
0,0,0,2019-09-19,clear-night,nan
166,74,92,2019-02-22,partly-cloudy-day,nan
285,128,157,2019-07-02,clear-day,nan
1179,666,513,2019-08-30,clear-day,nan
3,0,3,2019-07-04,clear-day,Independence Day
11,9,2,2019-12-31,cloudy,nan
1027,468,559,2019-01-13,partly-cloudy-day,nan
9,7,2,2019-01-11,clear-night,nan
9,4,5,2019-02-16,clear-night,nan
1460,723,737,2019-09-23,partly-cloudy-day,nan
9,6,3,2019-02-05,clear-night,nan
769,317,452,2019-01-15,clear-day,nan
26,8,18,2019-07-23,rain,nan
0,0,0,2019-10-10,cloudy,nan
1366,649,717,2019-08-21,partly-cloudy-day,nan
2,1,1,2019-09-30,partly-cloudy-night,nan
1994,925,1069,2019-08-18,partly-cloudy-day,nan
1,0,1,2019-07-12,cloudy,nan
677,350,327,2019-03-07,clear-day,nan
83,61,22,2019-07-27,clear-night,nan
0,0,0,2019-10-29,cloudy,nan
2485,1206,1279,2019-12-08,clear-day,nan
0,0,0,2019-07-30,clear-night,nan
71,71,0,2019-02-18,clear-night,Presidents' Day (regional holiday)
0,0,0,2019-01-02,clear-night,nan
410,184,226,2019-11-25,clear-day,nan
50,23,27,2019-08-11,clear-night,nan
0,0,0,2019-11-30,clear-night,nan
12,8,4,2019-03-11,clear-night,nan
29,25,4,2019-03-30,clear-night,nan
2899,1301,1598,2019-01-02,partly-cloudy-day,nan
0,0,0,2019-12-27,cloudy,nan
365,207,158,2019-02-20,snow,nan
10,0,10,2019-01-25,clear-night,nan
847,397,450,2019-03-31,partly-cloudy-day,nan
1034,451,583,2019-01-07,partly-cloudy-day,nan
1560,939,621,2019-08-08,partly-cloudy-day,nan
1859,888,971,2019-12-24,clear-day,Christmas Eve
12,3,9,2019-05-06,partly-cloudy-night,nan
259,111,148,2019-08-16,partly-cloudy-day,nan
1521,843,678,2019-03-04,partly-cloudy-day,nan
4,3,1,2019-06-27,partly-cloudy-night,nan
1,1,0,2019-09-06,partly-cloudy-night,nan
15,13,2,2019-03-14,clear-night,nan
0,0,0,2019-02-04,clear-night,nan
1078,671,407,2019-10-26,clear-day,nan
352,151,201,2019-08-31,partly-cloudy-day,nan
52,19,33,2019-01-24,rain,nan
1626,730,896,2019-03-11,clear-day,nan
722,423,299,2019-11-23,clear-day,nan
177,63,114,2019-01-17,partly-cloudy-day,nan
35,26,9,2019-10-19,clear-night,nan
0,0,0,2019-11-18,cloudy,nan
277,125,152,2019-08-27,partly-cloudy-day,nan
7,2,5,2019-03-03,snow,nan
2019,1151,868,2019-05-31,clear-day,nan
245,140,105,2019-01-13,partly-cloudy-day,nan
9,8,1,2019-01-03,partly-cloudy-night,nan
3807,2435,1372,2019-12-25,clear-day,Christmas Day
30,11,19,2019-06-05,partly-cloudy-night,nan
1820,744,1076,2019-10-01,partly-cloudy-day,nan
3352,1501,1851,2019-05-04,partly-cloudy-day,nan
3,1,2,2019-07-01,clear-night,nan
1489,799,690,2019-06-20,cloudy,nan
879,510,369,2019-12-30,rain,nan
2059,897,1162,2019-08-12,partly-cloudy-day,nan
440,175,265,2019-06-06,partly-cloudy-day,nan
284,152,132,2019-07-08,rain,nan
29,16,13,2019-06-16,cloudy,Father's Day
33,31,2,2019-06-22,clear-night,nan
2,0,2,2019-12-14,rain,nan
0,0,0,2019-01-18,cloudy,nan
64,58,6,2019-05-15,partly-cloudy-night,nan
22,8,14,2019-05-08,clear-night,nan
2143,1072,1071,2019-05-15,partly-cloudy-day,nan
3,3,0,2019-01-09,nan,nan
3,0,3,2019-12-23,clear-night,nan
29,17,12,2019-01-17,cloudy,nan
0,0,0,2019-10-23,partly-cloudy-night,nan
11,10,1,2019-01-29,rain,nan
1518,709,809,2019-05-21,clear-day,nan
1,0,1,2019-06-25,cloudy,nan
1223,611,612,2019-06-11,clear-day,nan
29,9,20,2019-08-16,partly-cloudy-night,nan
11,6,5,2019-01-27,partly-cloudy-night,nan
698,312,386,2019-05-03,cloudy,nan
1494,646,848,2019-11-06,clear-day,nan
749,436,313,2019-07-19,cloudy,nan
0,0,0,2019-10-16,clear-night,nan
1863,999,864,2019-07-07,partly-cloudy-day,nan
3103,1367,1736,2019-04-19,partly-cloudy-day,nan
232,124,108,2019-05-12,rain,Mother's Day
0,0,0,2019-01-18,partly-cloudy-night,nan
221,92,129,2019-11-15,clear-day,nan
807,466,341,2019-07-05,cloudy,nan
1139,547,592,2019-12-03,clear-day,nan
3383,1646,1737,2019-05-11,clear-day,nan
50,37,13,2019-07-07,partly-cloudy-night,nan
35,21,14,2019-07-31,partly-cloudy-night,nan
2,0,2,2019-03-18,clear-night,nan
833,430,403,2019-08-28,rain,nan
0,0,0,2019-01-12,partly-cloudy-day,nan
1388,624,764,2019-06-28,partly-cloudy-day,nan
0,0,0,2019-02-02,clear-night,nan
1399,652,747,2019-11-17,partly-cloudy-day,nan
36,13,23,2019-01-01,partly-cloudy-night,New Year's Day
22,18,4,2019-06-09,clear-night,nan
2086,1043,1043,2019-03-09,clear-day,nan
66,58,8,2019-09-22,clear-night,nan
888,367,521,2019-03-31,cloudy,nan
2483,1179,1304,2019-11-29,clear-day,Black Friday
965,497,468,2019-09-12,partly-cloudy-day,nan
0,0,0,2019-02-27,cloudy,nan
535,179,356,2019-01-06,partly-cloudy-night,nan
1449,692,757,2019-03-26,clear-day,nan
2945,1321,1624,2019-09-28,partly-cloudy-day,nan
2016,823,1193,2019-09-03,clear-day,nan
7,5,2,2019-01-07,partly-cloudy-night,nan
1741,979,762,2019-08-18,partly-cloudy-day,nan
2173,871,1302,2019-08-01,partly-cloudy-day,nan
44,17,27,2019-07-20,clear-night,nan
84,70,14,2019-06-08,clear-night,nan
502,282,220,2019-05-05,rain,Cinco de Mayo
2,0,2,2019-12-30,rain,nan
4,3,1,2019-02-03,clear-night,nan
284,139,145,2019-08-13,partly-cloudy-night,nan
1507,815,692,2019-09-15,partly-cloudy-day,nan
1,0,1,2019-10-07,cloudy,nan
52,46,6,2019-03-30,clear-night,nan
911,500,411,2019-05-01,cloudy,nan
1548,681,867,2019-04-11,cloudy,nan
1366,816,550,2019-05-16,partly-cloudy-day,nan
77,38,39,2019-01-31,clear-day,nan
455,151,304,2019-07-21,clear-day,nan
3,2,1,2019-08-22,partly-cloudy-night,nan
0,0,0,2019-09-29,clear-night,nan
747,454,293,2019-11-26,clear-day,nan
415,236,179,2019-06-23,clear-day,nan
52,38,14,2019-07-14,clear-night,nan
509,186,323,2019-04-16,clear-day,nan
1824,873,951,2019-09-17,clear-day,nan
2152,962,1190,2019-06-02,partly-cloudy-day,nan
1244,509,735,2019-05-14,cloudy,nan
40,39,1,2019-04-10,clear-night,nan
679,378,301,2019-01-02,partly-cloudy-day,nan
25,0,25,2019-10-29,rain,nan
0,0,0,2019-11-12,partly-cloudy-night,nan
1823,1027,796,2019-05-27,clear-day,Memorial Day
1383,758,625,2019-06-03,partly-cloudy-day,nan
1827,826,1001,2019-06-17,cloudy,nan
763,407,356,2019-11-04,clear-day,nan
2,1,1,2019-05-20,partly-cloudy-night,nan
1514,939,575,2019-06-07,clear-day,nan
2037,966,1071,2019-02-21,partly-cloudy-day,nan
1,0,1,2019-03-25,cloudy,nan
103,0,103,2019-12-20,clear-night,nan
2,0,2,2019-06-12,clear-night,nan
4286,2121,2165,2019-05-25,partly-cloudy-day,nan
863,347,516,2019-06-18,cloudy,nan
44,34,10,2019-09-04,partly-cloudy-night,nan
40,33,7,2019-05-17,rain,nan
2499,1390,1109,2019-09-01,partly-cloudy-day,nan
66,60,6,2019-10-03,cloudy,nan
0,0,0,2019-11-01,partly-cloudy-night,nan
105,67,38,2019-10-02,partly-cloudy-night,nan
1748,855,893,2019-11-28,cloudy,Thanksgiving Day
1379,643,736,2019-03-20,clear-day,nan
1076,648,428,2019-12-31,cloudy,New Year's Eve
0,0,0,2019-03-07,clear-night,nan
4,1,3,2019-12-26,clear-night,nan
1476,768,708,2019-05-17,partly-cloudy-day,nan
79,40,39,2019-05-04,partly-cloudy-day,nan
41,23,18,2019-01-04,clear-night,nan
71,30,41,2019-03-01,fog,nan
2169,1019,1150,2019-06-14,cloudy,nan
2213,1182,1031,2019-10-23,clear-day,nan
7,0,7,2019-12-28,clear-night,nan
2235,946,1289,2019-05-18,clear-day,nan
0,0,0,2019-02-08,cloudy,nan
694,388,306,2019-08-29,clear-day,nan
266,119,147,2019-05-17,clear-day,nan
433,268,165,2019-01-20,rain,nan
12,6,6,2019-05-12,cloudy,nan
33,13,20,2019-06-14,clear-night,nan
16,0,16,2019-04-12,rain,nan
2372,893,1479,2019-11-01,clear-day,nan
28,17,11,2019-06-28,clear-night,nan
1047,385,662,2019-10-29,cloudy,nan
90,59,31,2019-11-16,clear-night,nan
19,17,2,2019-10-04,clear-night,nan
2237,1075,1162,2019-09-20,clear-day,nan
3062,1590,1472,2019-08-31,partly-cloudy-day,nan
12,3,9,2019-05-13,cloudy,nan
692,254,438,2019-10-16,cloudy,nan
3425,1499,1926,2019-04-13,partly-cloudy-day,nan
1248,606,642,2019-03-22,partly-cloudy-day,nan
736,340,396,2019-01-10,partly-cloudy-day,nan
227,104,123,2019-02-05,partly-cloudy-night,nan
287,141,146,2019-11-29,clear-day,Black Friday
398,158,240,2019-06-28,clear-day,nan
28,21,7,2019-04-25,cloudy,nan
1628,807,821,2019-08-13,cloudy,nan
11,10,1,2019-12-10,rain,nan
124,51,73,2019-01-24,rain,nan
0,0,0,2019-01-21,partly-cloudy-night,Martin Luther King Jr. Day
22,21,1,2019-12-02,snow,nan
9,5,4,2019-09-02,partly-cloudy-night,nan
2080,915,1165,2019-08-26,partly-cloudy-day,nan
0,0,0,2019-11-02,clear-night,nan
1730,923,807,2019-04-30,partly-cloudy-day,nan
2,2,0,2019-02-13,rain,nan
1571,676,895,2019-06-15,partly-cloudy-day,Father's Day
850,389,461,2019-01-11,clear-day,nan
31,16,15,2019-08-09,partly-cloudy-night,nan
676,299,377,2019-08-17,partly-cloudy-night,nan
1686,697,989,2019-03-18,clear-day,nan
640,367,273,2019-09-05,partly-cloudy-day,nan
3074,1323,1751,2019-10-13,partly-cloudy-day,nan
37,27,10,2019-05-17,partly-cloudy-night,nan
275,119,156,2019-03-08,partly-cloudy-night,nan
1917,1067,850,2019-05-31,partly-cloudy-day,nan
247,164,83,2019-12-28,partly-cloudy-night,nan
0,0,0,2019-10-04,cloudy,nan
8,4,4,2019-09-26,clear-night,nan
302,133,169,2019-09-07,clear-day,nan
3369,1368,2001,2019-08-24,partly-cloudy-day,nan
3052,1538,1514,2019-06-22,partly-cloudy-day,nan
3,2,1,2019-01-09,clear-night,nan
10,9,1,2019-12-22,clear-night,nan
5,1,4,2019-07-22,partly-cloudy-night,nan
1,1,0,2019-01-16,clear-night,nan
1,0,1,2019-02-26,clear-night,nan
97,49,48,2019-12-02,rain,nan
1824,1062,762,2019-04-20,cloudy,nan
1909,946,963,2019-06-24,clear-day,nan
418,234,184,2019-01-03,partly-cloudy-night,nan
50,0,50,2019-12-15,partly-cloudy-night,nan
119,61,58,2019-04-22,clear-night,Easter Monday
2367,1181,1186,2019-06-08,clear-day,nan
57,53,4,2019-11-23,clear-night,nan
20,14,6,2019-11-11,clear-night,Veterans Day
2367,1168,1199,2019-08-16,partly-cloudy-day,nan
5,4,1,2019-07-12,partly-cloudy-night,nan
524,236,288,2019-11-12,cloudy,nan
5,0,5,2019-03-22,rain,nan
862,296,566,2019-09-14,cloudy,nan
482,283,199,2019-12-01,cloudy,nan
2711,1508,1203,2019-12-29,partly-cloudy-day,nan
33,12,21,2019-06-18,cloudy,nan
2,0,2,2019-01-27,partly-cloudy-night,nan
1,0,1,2019-07-11,cloudy,nan
1292,563,729,2019-12-11,cloudy,nan
27,26,1,2019-12-03,clear-night,nan
574,275,299,2019-04-12,cloudy,nan
217,152,65,2019-10-27,rain,nan
1,0,1,2019-04-14,partly-cloudy-night,nan
1494,801,693,2019-05-22,clear-day,nan
96,31,65,2019-07-16,partly-cloudy-night,nan
4,3,1,2019-03-24,clear-night,nan
1087,568,519,2019-05-09,cloudy,nan
258,125,133,2019-10-22,cloudy,nan
1715,924,791,2019-12-27,partly-cloudy-day,nan
405,216,189,2019-10-13,partly-cloudy-day,nan
58,42,16,2019-04-17,partly-cloudy-night,nan
18,12,6,2019-12-21,clear-night,nan
364,150,214,2019-12-06,partly-cloudy-day,nan
86,36,50,2019-05-14,cloudy,nan
429,201,228,2019-12-16,cloudy,nan
826,414,412,2019-02-06,cloudy,nan
308,142,166,2019-09-25,clear-night,nan
1371,662,709,2019-02-05,partly-cloudy-day,nan
4,0,4,2019-04-21,clear-night,Easter Monday
16,14,2,2019-03-06,partly-cloudy-night,nan
397,208,189,2019-11-20,partly-cloudy-day,nan
0,0,0,2019-04-08,rain,nan
959,428,531,2019-04-28,cloudy,nan
969,458,511,2019-09-09,partly-cloudy-day,nan
0,0,0,2019-06-23,clear-night,nan
1,0,1,2019-01-19,partly-cloudy-night,nan
315,119,196,2019-11-07,partly-cloudy-day,nan
1,0,1,2019-05-19,partly-cloudy-night,nan
1385,608,777,2019-04-28,cloudy,nan
1506,648,858,2019-09-26,partly-cloudy-day,nan
588,272,316,2019-11-01,clear-night,nan
3,1,2,2019-07-28,clear-night,nan
1699,762,937,2019-11-06,clear-day,nan
836,506,330,2019-05-18,clear-day,nan
25,18,7,2019-07-18,rain,nan
0,0,0,2019-07-26,clear-night,nan
3302,1384,1918,2019-05-11,partly-cloudy-day,nan
1453,856,597,2019-05-26,rain,nan
1778,898,880,2019-05-08,partly-cloudy-day,nan
157,72,85,2019-06-06,partly-cloudy-day,nan
2749,1205,1544,2019-08-04,partly-cloudy-day,nan
1719,776,943,2019-05-20,partly-cloudy-day,nan
0,0,0,2019-05-29,clear-night,nan
0,0,0,2019-08-26,clear-night,nan
5,4,1,2019-01-05,cloudy,nan
0,0,0,2019-10-01,cloudy,nan
0,0,0,2019-05-30,cloudy,nan
402,208,194,2019-01-14,clear-night,nan
4,4,0,2019-02-19,clear-night,nan
1702,775,927,2019-04-30,partly-cloudy-day,nan
1,0,1,2019-12-30,cloudy,New Year's Eve
2165,936,1229,2019-11-03,partly-cloudy-day,Daylight Saving Time ends
1969,980,989,2019-07-02,partly-cloudy-day,nan
100,48,52,2019-03-23,partly-cloudy-night,nan
47,36,11,2019-07-29,clear-night,nan
2259,1100,1159,2019-08-16,partly-cloudy-day,nan
1719,772,947,2019-03-20,partly-cloudy-day,nan
2189,1048,1141,2019-11-09,clear-day,nan
1894,872,1022,2019-10-07,partly-cloudy-day,nan
17,0,17,2019-02-24,cloudy,nan
0,0,0,2019-09-20,clear-night,nan
18,5,13,2019-06-04,clear-night,nan
539,265,274,2019-01-28,clear-day,nan
1,0,1,2019-12-01,clear-night,nan
2258,974,1284,2019-06-11,clear-day,nan
1717,893,824,2019-07-09,clear-day,nan
0,0,0,2019-11-26,clear-night,nan
9,5,4,2019-07-19,cloudy,nan
808,296,512,2019-08-19,clear-day,nan
1241,552,689,2019-11-14,partly-cloudy-day,nan
27,19,8,2019-05-31,cloudy,nan
206,87,119,2019-03-12,clear-night,nan
1632,736,896,2019-03-02,partly-cloudy-day,nan
2507,1077,1430,2019-10-18,partly-cloudy-day,nan
2926,1394,1532,2019-09-07,clear-day,nan
207,88,119,2019-06-12,clear-day,nan
0,0,0,2019-03-28,clear-night,nan
1847,950,897,2019-08-29,clear-day,nan
507,168,339,2019-03-17,clear-day,St. Patrick's Day
190,97,93,2019-06-30,clear-day,nan
2770,1281,1489,2019-03-09,clear-day,nan
2255,1184,1071,2019-12-22,clear-day,nan
54,48,6,2019-09-13,partly-cloudy-night,nan
153,68,85,2019-01-25,cloudy,nan
1370,623,747,2019-04-02,partly-cloudy-day,nan
2911,1361,1550,2019-04-19,partly-cloudy-day,nan
79,74,5,2019-11-21,clear-night,nan
190,160,30,2019-01-22,partly-cloudy-night,nan
1306,667,639,2019-02-04,clear-day,nan
330,122,208,2019-11-11,clear-day,Veterans Day
1558,804,754,2019-06-24,clear-day,nan
1,0,1,2019-02-07,rain,nan
2666,1252,1414,2019-08-11,partly-cloudy-day,nan
5,5,0,2019-12-07,clear-night,nan
513,238,275,2019-04-01,clear-day,nan
305,117,188,2019-08-20,clear-day,nan
1192,682,510,2019-05-28,partly-cloudy-day,nan
22,11,11,2019-07-29,clear-night,nan
51,50,1,2019-05-12,cloudy,Mother's Day
90,47,43,2019-02-18,cloudy,Presidents' Day (regional holiday)
3554,1450,2104,2019-10-12,partly-cloudy-day,nan
1,0,1,2019-01-20,rain,nan
1407,799,608,2019-07-17,partly-cloudy-day,nan
1239,676,563,2019-07-03,partly-cloudy-day,nan
255,104,151,2019-05-28,clear-day,nan
1416,687,729,2019-03-18,clear-day,nan
1744,703,1041,2019-03-16,partly-cloudy-day,nan
1,0,1,2019-08-02,partly-cloudy-night,nan
6,5,1,2019-04-01,clear-night,nan
2489,1124,1365,2019-11-09,clear-day,nan
7,3,4,2019-09-12,partly-cloudy-night,nan
79,63,16,2019-07-25,clear-night,nan
474,155,319,2019-09-24,clear-day,nan
2280,1297,983,2019-07-27,partly-cloudy-day,nan
2405,1281,1124,2019-08-05,partly-cloudy-day,nan
353,167,186,2019-01-21,partly-cloudy-day,Martin Luther King Jr. Day
222,77,145,2019-11-18,cloudy,nan
69,43,26,2019-11-13,clear-night,nan
576,299,277,2019-02-20,cloudy,nan
1,1,0,2019-03-11,cloudy,nan
19,11,8,2019-08-20,clear-night,nan
1544,715,829,2019-09-10,cloudy,nan
32,30,2,2019-02-14,clear-night,Valentine's Day
1617,708,909,2019-11-27,cloudy,nan
21,14,7,2019-02-12,cloudy,nan
3,1,2,2019-04-07,partly-cloudy-night,nan
0,0,0,2019-04-03,partly-cloudy-night,nan
1,0,1,2019-07-04,clear-night,Independence Day
1413,563,850,2019-07-17,clear-day,nan
37,33,4,2019-09-15,cloudy,nan
592,279,313,2019-02-01,cloudy,nan
2944,1452,1492,2019-08-24,partly-cloudy-day,nan
0,0,0,2019-05-07,partly-cloudy-night,nan
3,2,1,2019-05-08,partly-cloudy-night,nan
1867,1030,837,2019-04-08,partly-cloudy-day,nan
971,469,502,2019-06-13,partly-cloudy-day,nan
0,0,0,2019-10-31,rain,Halloween
384,220,164,2019-01-29,cloudy,nan
1697,949,748,2019-09-24,partly-cloudy-day,nan
213,213,0,2019-02-19,clear-night,nan
0,0,0,2019-04-03,cloudy,nan
1269,588,681,2019-02-28,clear-day,nan
0,0,0,2019-09-19,clear-night,nan
0,0,0,2019-04-17,cloudy,nan
1908,990,918,2019-04-08,partly-cloudy-day,nan
824,488,336,2019-04-07,clear-day,nan
1,0,1,2019-09-02,partly-cloudy-night,Labor Day
1471,799,672,2019-06-06,partly-cloudy-day,nan
5,4,1,2019-01-23,cloudy,nan
13,9,4,2019-02-17,clear-night,nan
75,71,4,2019-11-25,clear-night,nan
69,54,15,2019-04-14,partly-cloudy-night,Tax Day
2,0,2,2019-06-21,partly-cloudy-night,nan
1,0,1,2019-11-24,rain,nan
288,130,158,2019-06-05,partly-cloudy-day,nan
73,62,11,2019-12-09,rain,nan
588,353,235,2019-02-23,clear-day,nan
2386,955,1431,2019-10-05,clear-day,nan
30,16,14,2019-04-25,clear-night,nan
2072,998,1074,2019-08-27,partly-cloudy-day,nan
302,175,127,2019-12-01,sleet,nan
31,22,9,2019-12-12,clear-night,nan
0,0,0,2019-03-10,nan,Daylight Saving Time starts
140,59,81,2019-07-05,cloudy,nan
1,0,1,2019-02-28,cloudy,nan
1333,648,685,2019-06-02,partly-cloudy-day,nan
0,0,0,2019-07-17,partly-cloudy-night,nan
395,159,236,2019-09-05,partly-cloudy-day,nan
48,46,2,2019-04-03,clear-night,nan
67,54,13,2019-06-01,partly-cloudy-night,nan
21,0,21,2019-03-30,partly-cloudy-night,nan
1124,482,642,2019-12-04,cloudy,nan
9,6,3,2019-02-23,cloudy,nan
5,4,1,2019-06-20,cloudy,nan
3056,1316,1740,2019-09-07,cloudy,nan
1036,515,521,2019-11-20,cloudy,nan
589,256,333,2019-01-30,partly-cloudy-day,nan
1,0,1,2019-12-05,partly-cloudy-night,nan
13,8,5,2019-01-20,rain,nan
319,144,175,2019-12-24,clear-day,Christmas Eve
976,477,499,2019-06-13,cloudy,nan
698,364,334,2019-05-07,cloudy,nan
4,3,1,2019-05-23,partly-cloudy-night,nan
1521,709,812,2019-03-14,clear-day,nan
416,194,222,2019-03-21,rain,nan
0,0,0,2019-02-05,partly-cloudy-night,nan
692,342,350,2019-01-14,clear-day,nan
8,2,6,2019-07-15,clear-night,nan
0,0,0,2019-12-17,rain,nan
878,389,489,2019-03-07,cloudy,nan
0,0,0,2019-08-11,clear-night,nan
9,9,0,2019-12-21,clear-night,nan
1393,642,751,2019-08-18,partly-cloudy-day,nan
216,91,125,2019-06-08,clear-day,nan
1377,635,742,2019-02-10,partly-cloudy-day,nan
90,71,19,2019-05-30,rain,nan
0,0,0,2019-11-17,cloudy,nan
326,159,167,2019-04-26,partly-cloudy-day,nan
0,0,0,2019-12-15,partly-cloudy-night,nan
2430,1169,1261,2019-05-24,partly-cloudy-day,nan
0,0,0,2019-02-12,cloudy,nan
1402,819,583,2019-06-17,partly-cloudy-day,nan
1443,625,818,2019-06-29,partly-cloudy-day,nan
2216,993,1223,2019-10-23,clear-day,nan
42,32,10,2019-08-09,clear-night,nan
303,114,189,2019-12-03,partly-cloudy-day,nan
0,0,0,2019-07-31,clear-night,nan
55,53,2,2019-12-06,rain,nan
1756,1071,685,2019-09-11,clear-day,nan
1,0,1,2019-10-15,clear-night,nan
198,87,111,2019-06-19,cloudy,nan
3633,1722,1911,2019-04-21,cloudy,Easter Sunday
0,0,0,2019-01-12,cloudy,nan
185,56,129,2019-01-10,cloudy,nan
1849,772,1077,2019-10-07,cloudy,nan
1,0,1,2019-02-16,clear-night,nan
1,0,1,2019-11-13,clear-night,nan
630,366,264,2019-02-28,clear-day,nan
0,0,0,2019-11-27,clear-night,nan
0,0,0,2019-12-10,cloudy,nan
316,118,198,2019-10-08,cloudy,nan
1393,637,756,2019-12-12,clear-day,nan
12,2,10,2019-09-16,partly-cloudy-night,nan
1365,732,633,2019-06-05,partly-cloudy-day,nan
0,0,0,2019-11-11,cloudy,Veterans Day
364,198,166,2019-06-15,partly-cloudy-day,nan
390,211,179,2019-07-20,partly-cloudy-day,nan
1249,758,491,2019-08-10,clear-day,nan
1,0,1,2019-09-11,clear-night,nan
1849,1034,815,2019-06-21,clear-day,nan
973,429,544,2019-02-26,partly-cloudy-day,nan
0,0,0,2019-10-11,partly-cloudy-night,nan
1,0,1,2019-12-15,partly-cloudy-night,nan
1949,876,1073,2019-04-04,clear-day,nan
0,0,0,2019-11-19,cloudy,nan
72,38,34,2019-02-26,clear-night,nan
26,14,12,2019-09-01,partly-cloudy-night,Labor Day
1,0,1,2019-11-03,clear-night,Daylight Saving Time ends
1664,778,886,2019-03-22,partly-cloudy-day,nan
926,392,534,2019-12-19,clear-day,nan
445,217,228,2019-10-05,clear-day,nan
43,30,13,2019-08-05,clear-night,nan
35,34,1,2019-12-19,cloudy,nan
0,0,0,2019-12-29,partly-cloudy-night,nan
877,437,440,2019-01-22,clear-day,nan
555,263,292,2019-05-10,cloudy,nan
2829,1504,1325,2019-05-25,partly-cloudy-day,nan
525,300,225,2019-08-23,rain,nan
1,0,1,2019-06-04,clear-night,nan
223,95,128,2019-03-08,clear-day,nan
8,0,8,2019-01-31,clear-night,nan
39,33,6,2019-04-06,clear-night,nan
655,427,228,2019-12-22,clear-day,nan
0,0,0,2019-10-09,cloudy,nan
2026,968,1058,2019-06-07,partly-cloudy-day,nan
0,0,0,2019-01-25,partly-cloudy-night,nan
0,0,0,2019-01-30,partly-cloudy-night,nan
422,202,220,2019-02-15,partly-cloudy-day,nan
0,0,0,2019-04-15,partly-cloudy-night,Tax Day
156,76,80,2019-10-31,rain,Halloween
115,81,34,2019-06-12,partly-cloudy-night,nan
0,0,0,2019-09-25,clear-night,nan
2212,1002,1210,2019-06-07,partly-cloudy-day,nan
1,0,1,2019-09-04,clear-night,nan
39,38,1,2019-11-21,partly-cloudy-night,nan
2567,1179,1388,2019-05-31,partly-cloudy-day,nan
1237,697,540,2019-02-21,partly-cloudy-day,nan
0,0,0,2019-09-22,clear-night,nan
2,1,1,2019-03-06,clear-night,nan
823,463,360,2019-11-02,clear-day,nan
2950,1276,1674,2019-03-24,clear-day,nan
64,47,17,2019-12-18,cloudy,nan
0,0,0,2019-11-21,partly-cloudy-night,nan
2578,1220,1358,2019-09-21,clear-day,nan
1,0,1,2019-08-27,partly-cloudy-night,nan
1988,962,1026,2019-07-26,partly-cloudy-day,nan
1,0,1,2019-12-03,cloudy,nan
0,0,0,2019-10-06,cloudy,nan
533,268,265,2019-12-13,cloudy,nan
2353,1132,1221,2019-10-25,partly-cloudy-day,nan
2828,1187,1641,2019-06-09,partly-cloudy-day,nan
535,327,208,2019-02-06,clear-day,nan
7,3,4,2019-03-31,partly-cloudy-night,nan
474,168,306,2019-04-29,clear-day,nan
2140,1041,1099,2019-02-17,clear-day,nan
1891,963,928,2019-08-22,partly-cloudy-day,nan
0,0,0,2019-03-30,cloudy,nan
1,0,1,2019-05-26,cloudy,nan
745,341,404,2019-07-30,partly-cloudy-day,nan
1277,716,561,2019-08-03,partly-cloudy-day,nan
0,0,0,2019-11-06,clear-night,nan
1434,521,913,2019-08-06,partly-cloudy-day,nan
744,379,365,2019-03-15,partly-cloudy-day,nan
2,0,2,2019-12-23,clear-night,nan
835,393,442,2019-04-15,partly-cloudy-day,Tax Day
2103,955,1148,2019-05-16,partly-cloudy-day,nan
1776,853,923,2019-03-29,partly-cloudy-day,nan
1,0,1,2019-09-12,partly-cloudy-night,nan
16,7,9,2019-05-23,cloudy,nan
2,2,0,2019-02-22,cloudy,nan
0,0,0,2019-03-19,partly-cloudy-night,nan
14,10,4,2019-03-15,partly-cloudy-night,nan
1110,606,504,2019-08-01,partly-cloudy-day,nan
1451,734,717,2019-02-22,clear-day,nan
3745,2141,1604,2019-12-28,clear-day,nan
0,0,0,2019-05-11,cloudy,nan
1284,659,625,2019-05-03,cloudy,nan
722,346,376,2019-05-05,rain,Cinco de Mayo
3,3,0,2019-01-14,partly-cloudy-night,nan
697,381,316,2019-10-11,partly-cloudy-day,nan
1,0,1,2019-04-10,partly-cloudy-night,nan
0,0,0,2019-10-17,partly-cloudy-night,nan
1,0,1,2019-01-28,clear-night,nan
1359,675,684,2019-02-09,clear-day,nan
2163,974,1189,2019-08-08,partly-cloudy-day,nan
2094,950,1144,2019-07-14,partly-cloudy-day,nan
2834,1345,1489,2019-04-27,partly-cloudy-day,nan
1,0,1,2019-10-28,partly-cloudy-night,nan
134,65,69,2019-08-07,partly-cloudy-night,nan
2,2,0,2019-03-05,clear-night,nan
1671,718,953,2019-03-16,partly-cloudy-day,nan
45,44,1,2019-09-21,clear-night,nan
171,77,94,2019-02-12,cloudy,nan
558,284,274,2019-03-23,partly-cloudy-day,nan
2603,1376,1227,2019-10-19,clear-day,nan
8,5,3,2019-11-28,clear-night,Thanksgiving Day
921,596,325,2019-08-25,partly-cloudy-day,nan
869,571,298,2019-09-14,partly-cloudy-day,nan
0,0,0,2019-10-30,cloudy,nan
5,3,2,2019-07-08,partly-cloudy-night,nan
18,6,12,2019-04-22,cloudy,nan
511,259,252,2019-07-28,partly-cloudy-day,nan
37,29,8,2019-08-14,partly-cloudy-night,nan
506,250,256,2019-10-22,cloudy,nan
198,98,100,2019-07-27,clear-day,nan
0,0,0,2019-03-17,clear-night,St. Patrick's Day
872,392,480,2019-01-07,clear-day,nan
1896,905,991,2019-01-26,partly-cloudy-day,nan
14,7,7,2019-06-10,fog,nan
2517,1222,1295,2019-11-30,clear-day,nan
32,31,1,2019-11-26,clear-night,nan
95,89,6,2019-12-23,clear-night,nan
2833,1209,1624,2019-08-11,partly-cloudy-day,nan
76,61,15,2019-10-06,cloudy,nan
1737,718,1019,2019-05-01,cloudy,nan
6,5,1,2019-06-27,clear-night,nan
42,33,9,2019-08-22,rain,nan
890,492,398,2019-04-29,clear-day,nan
700,337,363,2019-12-09,rain,nan
1470,726,744,2019-09-23,partly-cloudy-day,nan
0,0,0,2019-09-16,partly-cloudy-night,nan
0,0,0,2019-09-09,cloudy,nan
214,85,129,2019-02-25,partly-cloudy-day,nan
2,0,2,2019-12-12,clear-night,nan
1404,617,787,2019-11-14,clear-day,nan
0,0,0,2019-06-21,rain,nan
195,78,117,2019-04-09,cloudy,nan
111,47,64,2019-02-27,cloudy,nan
16,13,3,2019-09-27,clear-night,nan
912,555,357,2019-12-14,cloudy,nan
90,58,32,2019-05-04,partly-cloudy-night,Cinco de Mayo
85,76,9,2019-10-17,cloudy,nan
2227,907,1320,2019-02-16,clear-day,nan
45,21,24,2019-07-06,partly-cloudy-night,nan
270,134,136,2019-12-17,rain,nan
1,0,1,2019-10-03,rain,nan
641,324,317,2019-04-18,cloudy,nan
39,32,7,2019-10-26,partly-cloudy-night,nan
1869,1021,848,2019-08-23,partly-cloudy-day,nan
0,0,0,2019-09-27,clear-night,nan
38,14,24,2019-05-21,partly-cloudy-night,nan
2300,970,1330,2019-09-13,partly-cloudy-day,nan
238,79,159,2019-02-14,cloudy,Valentine's Day
2259,1371,888,2019-12-25,clear-day,Christmas Day
59,0,59,2019-11-04,clear-night,nan
150,70,80,2019-02-16,clear-day,nan
87,71,16,2019-04-23,partly-cloudy-night,nan
533,305,228,2019-08-21,partly-cloudy-day,nan
148,78,70,2019-08-18,cloudy,nan
1611,695,916,2019-11-08,clear-day,nan
2154,954,1200,2019-08-30,clear-day,nan
1,0,1,2019-03-24,clear-night,nan
0,0,0,2019-02-21,cloudy,nan
1,0,1,2019-05-15,cloudy,nan
1996,947,1049,2019-07-19,partly-cloudy-day,nan
860,492,368,2019-06-18,rain,nan
418,153,265,2019-07-09,clear-day,nan
1270,561,709,2019-12-13,cloudy,nan
221,88,133,2019-03-19,clear-day,nan
2228,969,1259,2019-07-04,clear-day,Independence Day
1,0,1,2019-01-31,clear-night,nan
24,23,1,2019-02-10,partly-cloudy-night,nan
138,99,39,2019-01-17,partly-cloudy-night,nan
0,0,0,2019-07-13,clear-night,nan
44,40,4,2019-12-02,cloudy,nan
0,0,0,2019-04-23,partly-cloudy-night,nan
835,467,368,2019-03-04,partly-cloudy-day,nan
529,293,236,2019-01-01,partly-cloudy-day,New Year's Day
992,589,403,2019-12-18,clear-day,nan
0,0,0,2019-03-08,clear-night,nan
2459,1123,1336,2019-11-23,clear-day,nan
246,117,129,2019-04-23,clear-night,nan
0,0,0,2019-12-02,cloudy,nan
1893,868,1025,2019-07-08,cloudy,nan
305,138,167,2019-03-01,cloudy,nan
1864,737,1127,2019-07-15,clear-day,nan
761,391,370,2019-09-17,clear-night,nan
75,55,20,2019-07-21,partly-cloudy-night,nan
0,0,0,2019-12-26,clear-night,nan
40,0,40,2019-11-30,clear-night,nan
1665,805,860,2019-02-15,partly-cloudy-day,nan
43,29,14,2019-01-08,cloudy,nan
1280,614,666,2019-04-15,partly-cloudy-day,Tax Day
84,43,41,2019-05-10,cloudy,nan
0,0,0,2019-08-15,cloudy,nan
26,23,3,2019-11-30,clear-night,nan
588,276,312,2019-06-26,clear-day,nan
0,0,0,2019-11-14,partly-cloudy-night,nan
1980,986,994,2019-03-11,clear-day,nan
483,133,350,2019-06-04,clear-day,nan
1300,739,561,2019-08-12,clear-day,nan
0,0,0,2019-12-19,clear-night,nan
0,0,0,2019-03-06,clear-night,nan
3,1,2,2019-02-11,partly-cloudy-night,nan
3305,1485,1820,2019-05-27,clear-day,Memorial Day
1551,765,786,2019-08-21,partly-cloudy-day,nan
3,2,1,2019-06-15,clear-night,nan
1,0,1,2019-01-17,clear-night,nan
60,41,19,2019-03-20,clear-night,nan
0,0,0,2019-05-22,clear-night,nan
2540,1167,1373,2019-04-24,clear-day,nan
2973,1431,1542,2019-04-20,cloudy,nan
5,1,4,2019-01-03,cloudy,nan
1230,669,561,2019-02-17,clear-day,nan
162,56,106,2019-11-13,clear-day,nan
2496,1082,1414,2019-04-24,clear-day,nan
1106,657,449,2019-07-25,clear-day,nan
1525,758,767,2019-03-13,partly-cloudy-day,nan
1378,623,755,2019-09-04,partly-cloudy-day,nan
0,0,0,2019-06-26,partly-cloudy-night,nan
1,0,1,2019-12-08,clear-night,nan
57,36,21,2019-01-15,clear-night,nan
3,2,1,2019-09-07,cloudy,nan
1,0,1,2019-04-30,cloudy,nan
2679,1314,1365,2019-04-16,clear-day,nan
456,273,183,2019-06-01,clear-day,nan
2,0,2,2019-01-08,partly-cloudy-night,nan
1,0,1,2019-10-17,partly-cloudy-night,nan
49,49,0,2019-12-26,cloudy,nan
100,94,6,2019-11-17,cloudy,nan
589,311,278,2019-09-03,clear-day,nan
38,37,1,2019-11-10,partly-cloudy-night,nan
1051,380,671,2019-06-20,cloudy,nan
16,14,2,2019-05-10,partly-cloudy-night,nan
46,17,29,2019-08-12,partly-cloudy-night,nan
0,0,0,2019-08-31,partly-cloudy-night,nan
7,6,1,2019-06-06,cloudy,nan
3,0,3,2019-09-23,clear-night,nan
1086,545,541,2019-07-21,partly-cloudy-day,nan
1432,645,787,2019-09-12,cloudy,nan
151,82,69,2019-05-09,clear-day,nan
1206,575,631,2019-07-23,cloudy,nan
2173,947,1226,2019-12-06,clear-day,nan
12,6,6,2019-10-17,cloudy,nan
0,0,0,2019-12-18,clear-night,nan
509,337,172,2019-07-31,rain,nan
681,287,394,2019-01-25,clear-day,nan
205,88,117,2019-10-16,partly-cloudy-night,nan
7,5,2,2019-10-04,rain,nan
3623,1550,2073,2019-09-01,partly-cloudy-day,nan
1,0,1,2019-06-02,partly-cloudy-night,nan
7,4,3,2019-01-06,partly-cloudy-night,nan
0,0,0,2019-02-06,clear-night,nan
4,0,4,2019-12-23,clear-night,Christmas Eve
0,0,0,2019-06-17,cloudy,nan
0,0,0,2019-10-28,partly-cloudy-night,nan
0,0,0,2019-06-13,partly-cloudy-night,nan
77,44,33,2019-05-15,partly-cloudy-night,nan
2331,973,1358,2019-10-10,partly-cloudy-day,nan
1,0,1,2019-12-24,clear-night,Christmas Eve
680,358,322,2019-01-26,clear-day,nan
4,3,1,2019-12-27,clear-night,nan
0,0,0,2019-03-15,clear-night,nan
51,37,14,2019-06-14,partly-cloudy-night,nan
469,187,282,2019-09-13,clear-day,nan
0,0,0,2019-02-02,clear-day,nan
98,81,17,2019-04-20,partly-cloudy-night,Easter Sunday
0,0,0,2019-11-25,clear-night,nan
4,0,4,2019-10-28,cloudy,nan
12,7,5,2019-06-21,rain,nan
0,0,0,2019-11-08,clear-night,nan
909,457,452,2019-01-18,cloudy,nan
0,0,0,2019-08-07,partly-cloudy-night,nan
313,122,191,2019-11-22,cloudy,nan
44,41,3,2019-08-25,partly-cloudy-night,nan
2498,1251,1247,2019-02-16,clear-day,nan
601,283,318,2019-04-05,cloudy,nan
482,188,294,2019-05-24,clear-day,nan
1804,747,1057,2019-05-14,cloudy,nan
12,5,7,2019-01-21,clear-night,Martin Luther King Jr. Day
1012,598,414,2019-06-25,partly-cloudy-day,nan
2037,867,1170,2019-10-24,clear-day,nan
0,0,0,2019-09-14,partly-cloudy-night,nan
1,0,1,2019-12-06,partly-cloudy-night,nan
2,1,1,2019-11-08,clear-night,nan
12,4,8,2019-08-18,rain,nan
0,0,0,2019-08-17,cloudy,nan
2,1,1,2019-05-06,cloudy,nan
6,3,3,2019-09-05,partly-cloudy-night,nan
3,2,1,2019-02-11,cloudy,nan
1809,803,1006,2019-05-08,partly-cloudy-day,nan
1,0,1,2019-12-05,partly-cloudy-night,nan
189,111,78,2019-05-13,cloudy,nan
0,0,0,2019-09-17,partly-cloudy-night,nan
1781,867,914,2019-05-09,cloudy,nan
1443,859,584,2019-05-06,cloudy,nan
1310,634,676,2019-07-20,partly-cloudy-day,nan
1,0,1,2019-07-24,rain,nan
1172,594,578,2019-02-05,partly-cloudy-day,nan
2,0,2,2019-02-28,cloudy,nan
1759,764,995,2019-06-27,partly-cloudy-day,nan
698,388,310,2019-01-05,rain,nan
946,534,412,2019-01-14,clear-day,nan
91,43,48,2019-03-07,partly-cloudy-day,nan
1571,678,893,2019-07-14,clear-day,nan
984,427,557,2019-01-20,cloudy,nan
1025,465,560,2019-01-11,clear-day,nan
1462,781,681,2019-06-28,partly-cloudy-day,nan
2164,870,1294,2019-09-20,clear-day,nan
3187,1571,1616,2019-04-13,partly-cloudy-day,nan
2682,1367,1315,2019-12-07,clear-day,nan
0,0,0,2019-03-04,cloudy,nan
81,77,4,2019-06-30,partly-cloudy-night,nan
3255,1423,1832,2019-04-27,partly-cloudy-day,nan
1,0,1,2019-03-12,clear-night,nan
14,0,14,2019-10-23,clear-night,nan
2074,961,1113,2019-06-30,partly-cloudy-day,nan
2063,990,1073,2019-06-14,partly-cloudy-day,nan
761,359,402,2019-06-18,rain,nan
21,20,1,2019-10-13,cloudy,nan
95,92,3,2019-02-06,rain,nan
1873,780,1093,2019-09-05,partly-cloudy-day,nan
17,9,8,2019-12-16,partly-cloudy-night,nan
126,68,58,2019-07-13,clear-night,nan
40,15,25,2019-08-31,clear-night,nan
284,164,120,2019-02-25,partly-cloudy-day,nan
0,0,0,2019-11-26,clear-night,nan
149,66,83,2019-02-18,cloudy,Presidents' Day (regional holiday)
334,163,171,2019-06-07,partly-cloudy-day,nan
74,41,33,2019-05-11,cloudy,Mother's Day
2568,1205,1363,2019-06-14,partly-cloudy-day,nan
284,127,157,2019-07-26,clear-day,nan
1975,882,1093,2019-10-23,clear-day,nan
4,0,4,2019-12-22,clear-night,nan
71,68,3,2019-11-06,clear-night,nan
58,47,11,2019-05-18,clear-night,nan
19,5,14,2019-04-30,partly-cloudy-night,nan
9,8,1,2019-02-12,cloudy,nan
83,32,51,2019-07-08,rain,nan
2606,1235,1371,2019-12-29,cloudy,nan
0,0,0,2019-02-15,clear-night,nan
63,32,31,2019-06-29,clear-night,nan
3005,1622,1383,2019-12-26,partly-cloudy-day,nan
78,47,31,2019-10-27,rain,nan
167,76,91,2019-03-26,clear-day,nan
2833,1327,1506,2019-05-19,clear-day,nan
121,48,73,2019-08-04,partly-cloudy-night,nan
1311,601,710,2019-07-29,partly-cloudy-day,nan
79,78,1,2019-05-11,cloudy,Mother's Day
3,0,3,2019-11-03,clear-night,nan
40,21,19,2019-01-21,partly-cloudy-day,Martin Luther King Jr. Day
268,135,133,2019-09-15,partly-cloudy-day,nan
2528,1128,1400,2019-09-29,clear-day,nan
3,2,1,2019-11-20,clear-night,nan
830,398,432,2019-12-04,cloudy,nan
935,418,517,2019-02-26,partly-cloudy-day,nan
1357,624,733,2019-07-31,partly-cloudy-day,nan
1582,726,856,2019-07-22,partly-cloudy-day,nan
252,109,143,2019-10-18,partly-cloudy-night,nan
1,0,1,2019-11-11,clear-night,nan
1589,906,683,2019-08-31,partly-cloudy-day,nan
2,0,2,2019-01-06,clear-night,nan
7,6,1,2019-03-23,clear-night,nan
3,1,2,2019-03-22,partly-cloudy-night,nan
234,112,122,2019-01-10,partly-cloudy-day,nan
27,22,5,2019-09-25,clear-night,nan
3,2,1,2019-06-28,clear-night,nan
0,0,0,2019-03-11,clear-night,nan
108,46,62,2019-06-13,rain,nan
162,86,76,2019-08-26,cloudy,nan
2,0,2,2019-05-06,rain,nan
17,4,13,2019-07-10,partly-cloudy-night,nan
848,326,522,2019-04-07,clear-day,nan
38,37,1,2019-12-01,clear-night,nan
1481,782,699,2019-12-23,clear-day,nan
703,344,359,2019-05-13,cloudy,nan
24,0,24,2019-11-14,partly-cloudy-night,nan
0,0,0,2019-01-15,clear-night,nan
3112,1444,1668,2019-07-27,partly-cloudy-day,nan
1278,592,686,2019-09-04,partly-cloudy-day,nan
116,50,66,2019-06-10,cloudy,nan
99,83,16,2019-08-04,partly-cloudy-night,nan
593,209,384,2019-07-31,cloudy,nan
4,2,2,2019-10-21,clear-night,nan
13,9,4,2019-02-23,cloudy,nan
22,6,16,2019-08-18,partly-cloudy-night,nan
11,8,3,2019-02-08,clear-night,nan
2,0,2,2019-01-04,clear-night,nan
1183,556,627,2019-11-07,cloudy,nan
22,9,13,2019-05-31,clear-night,nan
0,0,0,2019-05-22,clear-night,nan
2192,1118,1074,2019-08-26,partly-cloudy-day,nan
0,0,0,2019-10-13,clear-night,nan
806,418,388,2019-11-18,cloudy,nan
0,0,0,2019-01-24,cloudy,nan
2353,1342,1011,2019-08-24,clear-day,nan
153,94,59,2019-02-01,partly-cloudy-day,nan
91,89,2,2019-12-10,rain,nan
80,79,1,2019-11-14,clear-night,nan
2586,1242,1344,2019-04-17,clear-day,nan
591,305,286,2019-07-18,rain,nan
1744,878,866,2019-10-02,partly-cloudy-day,nan
680,341,339,2019-05-14,cloudy,nan
93,83,10,2019-09-12,cloudy,nan
325,138,187,2019-10-24,clear-night,nan
1723,968,755,2019-08-01,partly-cloudy-day,nan
0,0,0,2019-10-08,rain,nan
4,0,4,2019-04-28,clear-night,nan
54,54,0,2019-02-19,clear-night,nan
19,0,19,2019-11-23,cloudy,nan
20,7,13,2019-05-09,cloudy,nan
1657,939,718,2019-07-16,partly-cloudy-day,nan
1958,911,1047,2019-11-29,clear-day,Black Friday
2409,971,1438,2019-06-23,clear-day,nan
1259,659,600,2019-03-14,partly-cloudy-day,nan
0,0,0,2019-01-09,rain,nan
28,12,16,2019-03-02,cloudy,nan
233,92,141,2019-01-23,cloudy,nan
604,361,243,2019-07-04,partly-cloudy-day,Independence Day
3287,1494,1793,2019-09-07,partly-cloudy-day,nan
294,132,162,2019-08-30,clear-day,nan
1643,972,671,2019-06-04,clear-day,nan
1928,929,999,2019-10-04,partly-cloudy-day,nan
0,0,0,2019-01-28,clear-night,nan
2949,1346,1603,2019-10-05,clear-day,nan
0,0,0,2019-09-23,clear-night,nan
384,126,258,2019-06-05,partly-cloudy-day,nan
1498,649,849,2019-04-30,cloudy,nan
0,0,0,2019-11-01,clear-night,nan
1,0,1,2019-12-31,cloudy,New Year's Eve
0,0,0,2019-08-23,partly-cloudy-night,nan
98,33,65,2019-07-02,partly-cloudy-night,nan
94,64,30,2019-05-30,rain,nan
56,55,1,2019-12-28,clear-night,nan
0,0,0,2019-11-30,partly-cloudy-night,nan
2051,1048,1003,2019-09-20,clear-day,nan
765,377,388,2019-02-07,cloudy,nan
634,296,338,2019-01-29,cloudy,nan
2328,1135,1193,2019-12-07,clear-day,nan
278,114,164,2019-08-28,cloudy,nan
3115,1595,1520,2019-11-30,clear-day,nan
637,345,292,2019-04-11,cloudy,nan
44,41,3,2019-02-14,clear-night,Valentine's Day
17,9,8,2019-01-20,clear-night,nan
2,0,2,2019-12-11,cloudy,nan
79,65,14,2019-07-04,clear-night,Independence Day
1758,853,905,2019-06-29,partly-cloudy-day,nan
135,50,85,2019-03-01,cloudy,nan
905,409,496,2019-05-24,clear-day,nan
336,211,125,2019-04-07,clear-day,nan
1901,1007,894,2019-05-06,clear-day,nan
122,69,53,2019-04-13,cloudy,nan
2561,1131,1430,2019-08-16,partly-cloudy-day,nan
70,67,3,2019-07-17,rain,nan
577,270,307,2019-07-09,clear-day,nan
1885,804,1081,2019-03-28,clear-day,nan
20,16,4,2019-08-07,rain,nan
905,584,321,2019-08-11,clear-day,nan
0,0,0,2019-08-30,clear-night,nan
0,0,0,2019-12-25,clear-night,Christmas Day
2100,1315,785,2019-07-25,partly-cloudy-day,nan
259,116,143,2019-08-08,partly-cloudy-day,nan
93,92,1,2019-11-13,clear-night,nan
91,78,13,2019-01-27,partly-cloudy-night,nan
2,0,2,2019-02-28,clear-night,nan
1473,565,908,2019-03-27,clear-day,nan
1414,580,834,2019-04-02,partly-cloudy-day,nan
414,166,248,2019-04-04,clear-day,nan
16,7,9,2019-01-22,clear-night,nan
1093,597,496,2019-03-18,cloudy,nan
1946,881,1065,2019-07-03,partly-cloudy-day,nan
1681,734,947,2019-01-27,partly-cloudy-day,nan
1876,916,960,2019-06-24,partly-cloudy-day,nan
1,0,1,2019-12-17,rain,nan
1929,915,1014,2019-11-23,clear-day,nan
2,0,2,2019-03-08,clear-night,nan
1,0,1,2019-07-08,partly-cloudy-night,nan
245,118,127,2019-08-21,partly-cloudy-night,nan
1,0,1,2019-08-20,clear-night,nan
1433,688,745,2019-07-17,partly-cloudy-day,nan
404,181,223,2019-12-02,sleet,nan
1,0,1,2019-12-05,partly-cloudy-night,nan
18,16,2,2019-03-12,clear-night,nan
98,57,41,2019-09-14,cloudy,nan
94,60,34,2019-01-21,partly-cloudy-day,Martin Luther King Jr. Day
67,66,1,2019-12-11,clear-night,nan
42,27,15,2019-08-06,partly-cloudy-night,nan
33,16,17,2019-04-19,cloudy,nan
483,151,332,2019-05-07,cloudy,nan
1,0,1,2019-12-21,clear-night,nan
95,57,38,2019-10-04,partly-cloudy-night,nan
1605,853,752,2019-03-22,partly-cloudy-day,nan
0,0,0,2019-09-05,clear-night,nan
5,2,3,2019-10-09,cloudy,nan
11,7,4,2019-10-01,clear-night,nan
1654,805,849,2019-09-18,partly-cloudy-day,nan
932,558,374,2019-03-17,partly-cloudy-day,St. Patrick's Day
2868,1344,1524,2019-03-16,partly-cloudy-day,nan
1559,653,906,2019-07-22,partly-cloudy-day,nan
578,319,259,2019-11-27,partly-cloudy-day,nan
1324,586,738,2019-04-01,clear-day,nan
2423,1184,1239,2019-07-13,clear-day,nan
17,7,10,2019-06-18,cloudy,nan
515,255,260,2019-05-23,partly-cloudy-day,nan
479,225,254,2019-02-20,snow,nan
768,478,290,2019-09-02,partly-cloudy-day,Labor Day
50,36,14,2019-08-24,partly-cloudy-night,nan
51,44,7,2019-10-12,partly-cloudy-night,nan
1,0,1,2019-05-14,cloudy,nan
19,13,6,2019-04-08,partly-cloudy-night,nan
1175,578,597,2019-10-18,partly-cloudy-day,nan
1696,799,897,2019-11-08,clear-day,nan
1540,708,832,2019-09-24,partly-cloudy-day,nan
40,33,7,2019-09-28,partly-cloudy-night,nan
9,8,1,2019-03-29,cloudy,nan
33,31,2,2019-12-14,cloudy,nan
3,3,0,2019-03-26,clear-night,nan
17,8,9,2019-03-02,snow,nan
282,126,156,2019-04-17,cloudy,nan
1,0,1,2019-10-22,partly-cloudy-night,nan
33,32,1,2019-11-06,partly-cloudy-night,nan
145,47,98,2019-02-12,cloudy,nan
0,0,0,2019-11-22,partly-cloudy-night,nan
164,42,122,2019-02-20,clear-day,nan
597,290,307,2019-11-12,partly-cloudy-day,nan
1408,655,753,2019-01-25,partly-cloudy-day,nan
1549,782,767,2019-09-30,partly-cloudy-day,nan
69,67,2,2019-06-02,rain,nan
1458,672,786,2019-12-16,cloudy,nan
53,52,1,2019-03-28,partly-cloudy-night,nan
0,0,0,2019-06-05,partly-cloudy-night,nan
1951,848,1103,2019-06-01,clear-day,nan
1057,624,433,2019-10-17,cloudy,nan
86,54,32,2019-07-22,rain,nan
1285,588,697,2019-11-05,cloudy,nan
1,0,1,2019-07-05,cloudy,nan
0,0,0,2019-04-22,clear-night,Easter Monday
2,0,2,2019-10-04,rain,nan
0,0,0,2019-09-04,clear-night,nan
1992,871,1121,2019-09-30,partly-cloudy-day,nan
1521,760,761,2019-03-20,partly-cloudy-day,nan
0,0,0,2019-05-29,partly-cloudy-night,nan
2936,1362,1574,2019-07-05,partly-cloudy-day,nan
428,221,207,2019-11-12,cloudy,nan
192,92,100,2019-11-29,clear-night,Black Friday
408,217,191,2019-03-10,rain,Daylight Saving Time starts
2363,1207,1156,2019-11-01,clear-day,nan
1672,757,915,2019-09-19,clear-day,nan
0,0,0,2019-11-25,clear-night,nan
70,42,28,2019-07-20,partly-cloudy-day,nan
0,0,0,2019-03-09,cloudy,nan
5,4,1,2019-05-05,cloudy,Cinco de Mayo
51,49,2,2019-04-14,partly-cloudy-night,nan
2049,974,1075,2019-07-12,partly-cloudy-day,nan
7,0,7,2019-10-16,rain,nan
1266,726,540,2019-04-21,partly-cloudy-day,Easter Sunday
112,47,65,2019-01-29,partly-cloudy-night,nan
1,0,1,2019-06-24,clear-night,nan
102,44,58,2019-02-13,cloudy,nan
831,494,337,2019-02-10,clear-day,nan
54,42,12,2019-12-19,clear-night,nan
233,95,138,2019-09-19,clear-day,nan
3312,2555,757,2019-11-10,partly-cloudy-day,nan
0,0,0,2019-11-17,clear-night,nan
2545,1164,1381,2019-04-07,clear-day,nan
116,56,60,2019-05-18,clear-day,nan
0,0,0,2019-02-18,cloudy,Presidents' Day (regional holiday)
24,23,1,2019-11-22,clear-night,nan
1390,700,690,2019-08-13,cloudy,nan
65,59,6,2019-01-23,partly-cloudy-night,nan
400,181,219,2019-07-17,partly-cloudy-day,nan
1617,748,869,2019-03-14,partly-cloudy-day,nan
33,0,33,2019-12-06,clear-night,nan
81,0,81,2019-12-09,rain,nan
5,3,2,2019-10-31,cloudy,nan
224,90,134,2019-11-07,partly-cloudy-day,nan
15,7,8,2019-05-29,cloudy,nan
1137,441,696,2019-12-04,cloudy,nan
48,45,3,2019-01-09,partly-cloudy-night,nan
394,233,161,2019-01-30,clear-day,nan
31,25,6,2019-04-26,rain,nan
1963,1093,870,2019-07-08,partly-cloudy-day,nan
8,6,2,2019-06-13,rain,nan
1708,925,783,2019-09-10,partly-cloudy-day,nan
14,11,3,2019-01-05,cloudy,nan
0,0,0,2019-03-01,cloudy,nan
0,0,0,2019-10-08,cloudy,nan
0,0,0,2019-07-20,clear-night,nan
84,83,1,2019-01-26,partly-cloudy-night,nan
5,4,1,2019-02-04,clear-night,nan
4,1,3,2019-05-16,cloudy,nan
2,0,2,2019-11-03,clear-night,Daylight Saving Time ends
1720,773,947,2019-11-16,clear-day,nan
2413,949,1464,2019-09-22,clear-day,nan
306,139,167,2019-06-04,clear-day,nan
0,0,0,2019-03-18,clear-night,nan
3614,1588,2026,2019-05-04,partly-cloudy-day,nan
16,10,6,2019-07-30,partly-cloudy-night,nan
0,0,0,2019-02-25,partly-cloudy-night,nan
1,1,0,2019-04-06,cloudy,nan
279,109,170,2019-04-15,partly-cloudy-day,Tax Day
280,126,154,2019-01-17,partly-cloudy-day,nan
1071,603,468,2019-02-16,clear-day,nan
293,116,177,2019-10-09,partly-cloudy-day,nan
304,150,154,2019-08-21,partly-cloudy-day,nan
910,498,412,2019-09-05,partly-cloudy-day,nan
3223,1468,1755,2019-08-10,partly-cloudy-day,nan
13,10,3,2019-12-25,clear-night,Christmas Day
4,3,1,2019-01-27,partly-cloudy-night,nan
14,14,0,2019-03-16,partly-cloudy-night,nan
2587,1209,1378,2019-08-08,partly-cloudy-day,nan
1581,716,865,2019-02-22,clear-day,nan
43,21,22,2019-07-21,partly-cloudy-night,nan
962,459,503,2019-02-11,cloudy,nan
3137,1498,1639,2019-09-01,partly-cloudy-day,nan
312,171,141,2019-12-19,clear-day,nan
2506,1253,1253,2019-05-31,clear-day,nan
416,218,198,2019-12-28,clear-day,nan
461,232,229,2019-06-02,partly-cloudy-day,nan
2317,1038,1279,2019-09-13,partly-cloudy-day,nan
0,0,0,2019-11-28,partly-cloudy-night,Thanksgiving Day
1,0,1,2019-04-13,rain,nan
0,0,0,2019-05-03,cloudy,nan
1,0,1,2019-11-14,clear-night,nan
134,62,72,2019-05-26,partly-cloudy-day,nan
3272,1494,1778,2019-03-30,partly-cloudy-day,nan
106,55,51,2019-06-02,partly-cloudy-day,nan
67,47,20,2019-11-27,partly-cloudy-night,nan
178,103,75,2019-12-09,rain,nan
0,0,0,2019-03-08,clear-night,nan
41,27,14,2019-02-15,partly-cloudy-night,nan
15,0,15,2019-11-30,partly-cloudy-night,nan
218,106,112,2019-11-11,clear-day,Veterans Day
1,0,1,2019-02-11,cloudy,nan
0,0,0,2019-01-30,clear-night,nan
62,60,2,2019-11-02,partly-cloudy-night,Daylight Saving Time ends
30,29,1,2019-12-18,partly-cloudy-night,nan
581,307,274,2019-01-22,clear-day,nan
7,5,2,2019-02-17,cloudy,nan
85,83,2,2019-11-15,clear-night,nan
2073,1017,1056,2019-03-03,cloudy,nan
0,0,0,2019-11-25,clear-night,nan
1907,836,1071,2019-08-27,partly-cloudy-day,nan
2,0,2,2019-02-22,clear-night,nan
0,0,0,2019-04-15,partly-cloudy-night,nan
1203,691,512,2019-08-17,cloudy,nan
3245,1655,1590,2019-10-12,cloudy,nan
1896,900,996,2019-07-02,partly-cloudy-day,nan
2,0,2,2019-09-12,partly-cloudy-night,nan
121,72,49,2019-12-03,cloudy,nan
3123,1388,1735,2019-04-16,clear-day,nan
5,0,5,2019-02-24,cloudy,nan
94,50,44,2019-05-11,partly-cloudy-day,nan
67,61,6,2019-12-27,cloudy,nan
650,356,294,2019-04-22,rain,Easter Monday
1328,642,686,2019-05-28,cloudy,nan
1005,525,480,2019-03-02,cloudy,nan
28,12,16,2019-08-12,partly-cloudy-night,nan
21,17,4,2019-01-31,clear-night,nan
2717,1230,1487,2019-08-03,partly-cloudy-day,nan
27,26,1,2019-04-07,clear-night,nan
15,0,15,2019-12-13,rain,nan
682,399,283,2019-09-09,partly-cloudy-day,nan
27,26,1,2019-12-14,cloudy,nan
1308,700,608,2019-06-07,clear-day,nan
307,194,113,2019-03-05,clear-night,nan
0,0,0,2019-03-06,partly-cloudy-night,nan
30,30,0,2019-11-07,cloudy,nan
0,0,0,2019-04-29,clear-night,nan
2004,1012,992,2019-03-02,partly-cloudy-day,nan
1739,662,1077,2019-07-07,clear-day,nan
695,304,391,2019-02-27,partly-cloudy-day,nan
2234,938,1296,2019-10-11,cloudy,nan
2972,1221,1751,2019-04-14,cloudy,nan
27,22,5,2019-10-20,clear-night,nan
2092,956,1136,2019-04-29,clear-day,nan
77,40,37,2019-04-19,partly-cloudy-night,nan
1733,854,879,2019-05-08,partly-cloudy-day,nan
115,69,46,2019-02-22,clear-night,nan
1540,832,708,2019-10-25,partly-cloudy-day,nan
1765,994,771,2019-05-20,partly-cloudy-day,nan
1034,444,590,2019-09-21,clear-night,nan
3292,1578,1714,2019-10-19,clear-day,nan
8,0,8,2019-11-28,clear-night,Black Friday
1607,715,892,2019-06-19,cloudy,nan
1042,531,511,2019-03-31,cloudy,nan
188,140,48,2019-05-01,cloudy,nan
1,0,1,2019-08-13,cloudy,nan
1570,773,797,2019-04-10,partly-cloudy-day,nan
184,84,100,2019-03-18,clear-night,nan
112,55,57,2019-02-21,cloudy,nan
0,0,0,2019-07-27,clear-night,nan
72,69,3,2019-11-09,partly-cloudy-night,nan
17,4,13,2019-08-23,clear-night,nan
21,6,15,2019-08-02,clear-night,nan
0,0,0,2019-02-17,clear-night,nan
15,5,10,2019-01-28,clear-night,nan
54,53,1,2019-10-10,cloudy,nan
19,12,7,2019-06-05,partly-cloudy-night,nan
1,0,1,2019-08-07,partly-cloudy-night,nan
11,6,5,2019-10-28,partly-cloudy-night,nan
91,65,26,2019-09-03,partly-cloudy-night,nan
0,0,0,2019-06-07,clear-night,nan
72,37,35,2019-12-17,rain,nan
2,2,0,2019-12-01,rain,nan
2004,935,1069,2019-03-11,clear-day,nan
32,28,4,2019-03-24,clear-night,nan
2,1,1,2019-09-26,clear-night,nan
821,422,399,2019-03-06,partly-cloudy-day,nan
1859,807,1052,2019-09-16,partly-cloudy-day,nan
3190,1398,1792,2019-10-26,partly-cloudy-day,nan
718,366,352,2019-09-13,partly-cloudy-day,nan
0,0,0,2019-11-13,clear-night,nan
963,475,488,2019-04-29,partly-cloudy-day,nan
1427,706,721,2019-04-04,clear-day,nan
284,130,154,2019-09-27,clear-night,nan
31,19,12,2019-09-06,cloudy,nan
0,0,0,2019-04-09,cloudy,nan
4,3,1,2019-08-18,cloudy,nan
42,41,1,2019-11-08,clear-night,nan
1530,619,911,2019-12-12,clear-day,nan
2296,1048,1248,2019-07-06,partly-cloudy-day,nan
1159,1159,0,2019-02-19,clear-day,nan
520,288,232,2019-11-19,cloudy,nan
1052,590,462,2019-03-22,cloudy,nan
4,3,1,2019-12-06,clear-night,nan
2491,1122,1369,2019-10-14,partly-cloudy-day,Columbus Day (regional holiday)
1339,595,744,2019-06-26,partly-cloudy-day,nan
2107,958,1149,2019-04-18,cloudy,nan
3542,1584,1958,2019-04-13,clear-day,nan
1111,506,605,2019-10-22,cloudy,nan
1,0,1,2019-12-29,clear-night,nan
0,0,0,2019-02-14,cloudy,Valentine's Day
67,59,8,2019-02-13,partly-cloudy-night,nan
457,227,230,2019-09-16,partly-cloudy-night,nan
10,4,6,2019-01-20,rain,nan
0,0,0,2019-02-11,cloudy,nan
4,3,1,2019-01-08,cloudy,nan
45,45,0,2019-02-07,fog,nan
711,387,324,2019-04-15,partly-cloudy-day,Tax Day
9,8,1,2019-06-09,clear-night,nan
1189,506,683,2019-06-26,clear-day,nan
171,70,101,2019-05-22,clear-day,nan
80,47,33,2019-11-09,clear-night,nan
53,43,10,2019-07-21,clear-night,nan
192,91,101,2019-05-15,partly-cloudy-day,nan
1996,834,1162,2019-07-25,partly-cloudy-day,nan
0,0,0,2019-07-09,clear-night,nan
706,367,339,2019-05-28,rain,nan
1326,562,764,2019-03-25,cloudy,nan
0,0,0,2019-04-15,partly-cloudy-night,Tax Day
10,5,5,2019-09-17,clear-night,nan
31,30,1,2019-11-19,partly-cloudy-night,nan
0,0,0,2019-01-31,clear-night,nan
38,19,19,2019-04-17,partly-cloudy-night,nan
1585,1006,579,2019-07-30,partly-cloudy-day,nan
34,33,1,2019-03-16,cloudy,nan
3485,1638,1847,2019-01-01,partly-cloudy-day,New Year's Day
2,1,1,2019-06-14,partly-cloudy-night,nan
1282,661,621,2019-12-18,partly-cloudy-day,nan
251,146,105,2019-08-29,partly-cloudy-night,nan
1692,716,976,2019-07-16,clear-day,nan
1336,563,773,2019-11-21,clear-day,nan
900,401,499,2019-11-13,clear-day,nan
1465,817,648,2019-09-22,clear-day,nan
2167,990,1177,2019-08-29,partly-cloudy-day,nan
7,0,7,2019-12-30,cloudy,New Year's Eve
0,0,0,2019-03-23,cloudy,nan
447,251,196,2019-01-06,cloudy,nan
2399,1131,1268,2019-06-21,partly-cloudy-day,nan
29,26,3,2019-10-20,rain,nan
2271,941,1330,2019-08-25,partly-cloudy-day,nan
2188,1111,1077,2019-11-04,clear-day,nan
10,8,2,2019-11-17,cloudy,nan
2823,1189,1634,2019-03-24,clear-day,nan
277,119,158,2019-06-26,partly-cloudy-day,nan
127,111,16,2019-02-11,partly-cloudy-night,nan
0,0,0,2019-03-19,clear-night,nan
18,10,8,2019-04-28,partly-cloudy-night,nan
23,18,5,2019-12-08,clear-night,nan
1,0,1,2019-07-01,clear-night,nan
40,30,10,2019-10-23,clear-night,nan
779,458,321,2019-11-14,partly-cloudy-day,nan
2026,883,1143,2019-11-26,clear-day,nan
1,1,0,2019-06-01,clear-night,nan
0,0,0,2019-03-20,clear-night,nan
10,8,2,2019-12-24,clear-night,Christmas Eve
1,0,1,2019-11-14,clear-night,nan
1142,633,509,2019-09-26,cloudy,nan
1,0,1,2019-09-08,clear-night,nan
3244,1570,1674,2019-08-31,partly-cloudy-day,nan
1088,558,530,2019-05-10,partly-cloudy-day,nan
1624,697,927,2019-10-30,cloudy,nan
2,2,0,2019-08-10,clear-night,nan
1921,897,1024,2019-06-06,partly-cloudy-day,nan
49,47,2,2019-10-15,clear-night,nan
9,7,2,2019-12-19,clear-night,nan
221,162,59,2019-01-24,rain,nan
1044,474,570,2019-03-01,snow,nan
724,389,335,2019-09-27,clear-day,nan
680,402,278,2019-08-06,partly-cloudy-day,nan
241,98,143,2019-06-15,partly-cloudy-day,nan
243,114,129,2019-05-16,partly-cloudy-day,nan
1,1,0,2019-05-23,partly-cloudy-night,nan
93,43,50,2019-04-30,cloudy,nan
238,124,114,2019-06-22,clear-day,nan
39,20,19,2019-04-26,rain,nan
908,387,521,2019-06-03,clear-day,nan
182,108,74,2019-12-24,clear-night,Christmas Eve
1318,604,714,2019-03-27,clear-day,nan
1732,1002,730,2019-04-14,partly-cloudy-day,nan
1662,742,920,2019-03-08,clear-day,nan
0,0,0,2019-12-18,partly-cloudy-night,nan
255,102,153,2019-07-24,partly-cloudy-day,nan
1086,560,526,2019-04-23,clear-day,nan
43,0,43,2019-02-21,clear-night,nan
915,495,420,2019-09-25,clear-day,nan
1108,563,545,2019-03-13,clear-day,nan
72,70,2,2019-10-24,clear-night,nan
0,0,0,2019-12-04,clear-night,nan
1933,976,957,2019-08-30,partly-cloudy-day,nan
33,14,19,2019-05-19,partly-cloudy-night,nan
678,361,317,2019-07-26,clear-day,nan
3,0,3,2019-12-13,clear-night,nan
2009,931,1078,2019-05-08,partly-cloudy-day,nan
2166,983,1183,2019-10-10,partly-cloudy-day,nan
89,82,7,2019-06-23,clear-night,nan
1475,595,880,2019-03-13,partly-cloudy-day,nan
1432,704,728,2019-08-22,partly-cloudy-day,nan
177,86,91,2019-12-06,clear-night,nan
2121,1105,1016,2019-08-12,partly-cloudy-day,nan
1306,654,652,2019-06-27,partly-cloudy-day,nan
1223,418,805,2019-05-10,cloudy,nan
1955,938,1017,2019-03-24,clear-day,nan
402,222,180,2019-01-02,partly-cloudy-night,nan
0,0,0,2019-02-02,clear-day,nan
3,0,3,2019-11-23,clear-night,nan
440,205,235,2019-09-14,partly-cloudy-day,nan
0,0,0,2019-12-06,clear-night,nan
0,0,0,2019-05-09,partly-cloudy-night,nan
692,363,329,2019-07-15,clear-day,nan
1040,562,478,2019-07-29,clear-day,nan
1678,844,834,2019-06-19,cloudy,nan
50,34,16,2019-05-06,clear-night,nan
112,22,90,2019-06-13,rain,nan
542,266,276,2019-04-05,cloudy,nan
2,0,2,2019-07-04,clear-night,Independence Day
1337,583,754,2019-11-14,clear-day,nan
2401,1148,1253,2019-09-15,clear-day,nan
1,0,1,2019-05-21,clear-night,nan
0,0,0,2019-03-31,clear-night,nan
2939,1204,1735,2019-11-02,clear-day,nan
38,15,23,2019-06-20,fog,nan
610,330,280,2019-01-16,cloudy,nan
476,177,299,2019-09-17,clear-day,nan
2,0,2,2019-10-19,clear-night,nan
63,31,32,2019-04-25,cloudy,nan
1418,637,781,2019-05-09,cloudy,nan
251,134,117,2019-05-12,rain,Mother's Day
14,13,1,2019-10-26,partly-cloudy-night,nan
570,280,290,2019-05-14,cloudy,nan
6,3,3,2019-01-21,clear-night,Martin Luther King Jr. Day
0,0,0,2019-01-26,clear-night,nan
4,1,3,2019-06-25,partly-cloudy-night,nan
112,55,57,2019-03-15,partly-cloudy-night,nan
0,0,0,2019-02-28,cloudy,nan
23,21,2,2019-03-09,clear-night,nan
502,287,215,2019-04-09,cloudy,nan
9,4,5,2019-05-14,partly-cloudy-night,nan
2057,1067,990,2019-07-01,partly-cloudy-day,nan
467,186,281,2019-08-17,partly-cloudy-day,nan
1267,541,726,2019-03-05,clear-day,nan
1608,651,957,2019-08-07,partly-cloudy-day,nan
1635,862,773,2019-08-04,partly-cloudy-day,nan
2224,1164,1060,2019-06-23,clear-day,nan
1,0,1,2019-05-12,rain,Mother's Day
16,3,13,2019-05-24,clear-night,nan
0,0,0,2019-09-15,partly-cloudy-night,nan
0,0,0,2019-11-16,partly-cloudy-night,nan
1346,494,852,2019-05-25,partly-cloudy-day,nan
2243,993,1250,2019-01-06,partly-cloudy-day,nan
1597,647,950,2019-12-05,partly-cloudy-day,nan
951,472,479,2019-02-25,partly-cloudy-day,nan
1472,698,774,2019-10-27,partly-cloudy-day,nan
1556,945,611,2019-09-29,partly-cloudy-day,nan
1660,912,748,2019-06-06,partly-cloudy-day,nan
8,3,5,2019-07-08,clear-night,nan
2625,1344,1281,2019-12-07,clear-day,nan
378,209,169,2019-06-09,clear-day,nan
2124,899,1225,2019-06-22,clear-day,nan
2520,1111,1409,2019-04-20,partly-cloudy-day,nan
7,2,5,2019-08-02,partly-cloudy-night,nan
2477,1117,1360,2019-04-25,partly-cloudy-day,nan
141,77,64,2019-03-01,cloudy,nan
1,0,1,2019-09-25,clear-night,nan
2336,1018,1318,2019-06-12,partly-cloudy-day,nan
2,0,2,2019-01-04,clear-night,nan
390,193,197,2019-03-19,clear-day,nan
66,64,2,2019-10-25,partly-cloudy-night,nan
1731,757,974,2019-08-20,partly-cloudy-day,nan
1198,649,549,2019-08-28,cloudy,nan
453,152,301,2019-06-24,clear-day,nan
183,88,95,2019-01-06,cloudy,nan
125,59,66,2019-01-15,clear-night,nan
7,5,2,2019-01-10,partly-cloudy-night,nan
2075,864,1211,2019-10-20,cloudy,nan
1,0,1,2019-03-24,partly-cloudy-night,nan
1,0,1,2019-04-27,rain,nan
1,0,1,2019-08-20,clear-night,nan
2198,1009,1189,2019-06-09,clear-day,nan
1,0,1,2019-02-24,partly-cloudy-night,nan
1679,947,732,2019-06-08,clear-day,nan
152,89,63,2019-01-05,rain,nan
1,0,1,2019-01-11,clear-night,nan
222,88,134,2019-08-10,clear-night,nan
7,6,1,2019-12-22,clear-night,nan
2442,1212,1230,2019-08-03,clear-day,nan
23,21,2,2019-05-02,cloudy,nan
1,1,0,2019-02-20,clear-night,nan
497,180,317,2019-07-01,clear-day,nan
6,4,2,2019-12-25,clear-night,nan
14,0,14,2019-02-03,clear-night,nan
15,10,5,2019-01-01,rain,New Year's Day
401,227,174,2019-04-02,cloudy,nan
0,0,0,2019-09-30,partly-cloudy-night,nan
8,7,1,2019-11-16,clear-night,nan
82,73,9,2019-11-20,cloudy,nan
2255,1038,1217,2019-03-17,clear-day,St. Patrick's Day
44,24,20,2019-02-15,clear-night,nan
0,0,0,2019-02-09,clear-night,nan
2465,1152,1313,2019-07-13,partly-cloudy-day,nan
0,0,0,2019-10-18,partly-cloudy-night,nan
822,383,439,2019-05-15,clear-day,nan
0,0,0,2019-12-31,cloudy,New Year's Eve
1697,879,818,2019-06-28,partly-cloudy-day,nan
1809,929,880,2019-02-21,clear-day,nan
3,1,2,2019-01-12,clear-night,nan
3169,1381,1788,2019-04-23,clear-day,nan
8,4,4,2019-08-26,clear-night,nan
3,1,2,2019-04-17,cloudy,nan
1962,1025,937,2019-05-29,cloudy,nan
2,1,1,2019-04-26,cloudy,nan
1540,867,673,2019-06-24,partly-cloudy-day,nan
891,408,483,2019-12-10,rain,nan
428,252,176,2019-01-27,clear-day,nan
69,0,69,2019-12-08,clear-night,nan
359,183,176,2019-12-20,clear-day,nan
0,0,0,2019-03-16,partly-cloudy-night,nan
62,59,3,2019-06-01,clear-night,nan
7,2,5,2019-01-16,nan,nan
1,0,1,2019-08-14,partly-cloudy-night,nan
2125,1048,1077,2019-07-12,partly-cloudy-day,nan
3127,1245,1882,2019-09-14,cloudy,nan
9,6,3,2019-10-21,clear-night,nan
0,0,0,2019-08-01,partly-cloudy-night,nan
1480,621,859,2019-11-05,partly-cloudy-day,nan
267,107,160,2019-07-10,partly-cloudy-day,nan
301,162,139,2019-11-18,cloudy,nan
0,0,0,2019-04-03,cloudy,nan
2313,1388,925,2019-12-21,partly-cloudy-day,nan
177,81,96,2019-07-19,cloudy,nan
1662,756,906,2019-02-03,partly-cloudy-day,nan
1196,592,604,2019-01-09,partly-cloudy-day,nan
1,0,1,2019-06-20,cloudy,nan
0,0,0,2019-03-27,clear-night,nan
0,0,0,2019-01-22,clear-night,nan
2095,1043,1052,2019-05-17,partly-cloudy-day,nan
1041,490,551,2019-06-25,cloudy,nan
1273,603,670,2019-07-23,cloudy,nan
1871,975,896,2019-05-30,cloudy,nan
493,270,223,2019-05-13,rain,nan
155,103,52,2019-09-28,partly-cloudy-night,nan
2,0,2,2019-01-13,clear-night,nan
308,153,155,2019-12-15,partly-cloudy-day,nan
39,16,23,2019-07-26,partly-cloudy-night,nan
1573,738,835,2019-03-12,partly-cloudy-day,nan
1440,700,740,2019-12-03,clear-day,nan
1278,588,690,2019-07-18,cloudy,nan
0,0,0,2019-05-01,cloudy,nan
12,9,3,2019-05-13,cloudy,nan
47,41,6,2019-10-13,partly-cloudy-night,nan
2626,1389,1237,2019-07-06,partly-cloudy-day,nan
195,101,94,2019-02-08,rain,nan
402,181,221,2019-06-10,rain,nan
3,0,3,2019-12-17,cloudy,nan
740,370,370,2019-01-23,cloudy,nan
38,22,16,2019-11-17,cloudy,nan
0,0,0,2019-11-05,partly-cloudy-night,nan
5,0,5,2019-09-01,clear-night,nan
0,0,0,2019-03-07,clear-night,nan
25,8,17,2019-10-07,cloudy,nan
1657,533,1124,2019-08-14,cloudy,nan
249,138,111,2019-01-28,clear-day,nan
2276,1124,1152,2019-12-23,clear-day,nan
1386,614,772,2019-03-27,clear-day,nan
34,0,34,2019-02-01,clear-night,nan
137,34,103,2019-12-02,cloudy,nan
0,0,0,2019-08-21,partly-cloudy-night,nan
230,76,154,2019-03-13,clear-day,nan
2476,1176,1300,2019-05-18,clear-day,nan
15,5,10,2019-12-11,clear-night,nan
5,3,2,2019-11-05,clear-night,nan
1382,640,742,2019-05-30,partly-cloudy-day,nan
23,17,6,2019-10-11,cloudy,nan
1,0,1,2019-03-18,partly-cloudy-night,nan
22,22,0,2019-02-13,clear-night,nan
1536,745,791,2019-03-28,clear-day,nan
1890,1046,844,2019-09-08,partly-cloudy-day,nan
2416,1029,1387,2019-04-25,partly-cloudy-day,nan
497,150,347,2019-02-18,partly-cloudy-night,Presidents' Day (regional holiday)
1476,678,798,2019-10-02,partly-cloudy-day,nan
1538,892,646,2019-08-15,partly-cloudy-day,nan
978,471,507,2019-12-16,cloudy,nan
1513,513,1000,2019-09-06,cloudy,nan
65,61,4,2019-09-18,clear-night,nan
10,5,5,2019-09-10,clear-night,nan
2129,1047,1082,2019-09-19,clear-day,nan
2076,932,1144,2019-06-16,partly-cloudy-day,Father's Day
6,1,5,2019-10-04,clear-night,nan
2135,1052,1083,2019-05-04,cloudy,nan
2079,887,1192,2019-02-23,clear-day,nan
659,366,293,2019-05-19,partly-cloudy-day,nan
15,7,8,2019-08-15,partly-cloudy-night,nan
868,389,479,2019-01-17,partly-cloudy-day,nan
1,0,1,2019-08-28,partly-cloudy-night,nan
3,3,0,2019-02-13,cloudy,nan
760,345,415,2019-04-09,cloudy,nan
0,0,0,2019-03-03,partly-cloudy-night,nan
2,1,1,2019-01-24,rain,nan
1448,711,737,2019-02-14,clear-day,Valentine's Day
1667,941,726,2019-09-23,partly-cloudy-day,nan
1,0,1,2019-04-11,clear-night,nan
1471,818,653,2019-08-14,partly-cloudy-day,nan
838,838,0,2019-02-19,clear-day,nan
2231,1150,1081,2019-11-30,clear-day,nan
1381,799,582,2019-07-24,partly-cloudy-day,nan
3023,1362,1661,2019-06-01,clear-day,nan
1,0,1,2019-01-29,clear-night,nan
2089,962,1127,2019-05-02,partly-cloudy-day,nan
2218,968,1250,2019-04-12,partly-cloudy-day,nan
395,209,186,2019-07-05,cloudy,nan
2538,1102,1436,2019-10-06,cloudy,nan
0,0,0,2019-10-15,clear-night,nan
1,0,1,2019-12-11,rain,nan
307,116,191,2019-04-11,cloudy,nan
171,76,95,2019-10-09,rain,nan
1317,794,523,2019-04-27,clear-day,nan
0,0,0,2019-08-06,partly-cloudy-night,nan
371,164,207,2019-03-11,clear-night,nan
0,0,0,2019-09-05,clear-night,nan
0,0,0,2019-03-29,cloudy,nan
14,8,6,2019-05-13,cloudy,nan
3498,2123,1375,2019-12-25,clear-day,Christmas Day
1446,607,839,2019-11-08,partly-cloudy-day,nan
53,0,53,2019-10-18,clear-night,nan
304,164,140,2019-10-03,rain,nan
0,0,0,2019-03-05,partly-cloudy-night,nan
0,0,0,2019-12-16,partly-cloudy-night,nan
625,295,330,2019-11-24,rain,nan
1155,649,506,2019-08-14,cloudy,nan
1733,792,941,2019-04-03,clear-day,nan
4,0,4,2019-11-15,clear-night,nan
4,3,1,2019-11-27,cloudy,Thanksgiving Day
6,0,6,2019-06-18,cloudy,nan
19,11,8,2019-02-12,rain,nan
313,130,183,2019-09-03,clear-day,nan
1,0,1,2019-05-27,clear-night,Memorial Day
7,0,7,2019-03-20,partly-cloudy-night,nan
1498,780,718,2019-02-18,partly-cloudy-day,Presidents' Day (regional holiday)
7,5,2,2019-04-21,cloudy,Easter Sunday
0,0,0,2019-04-02,clear-night,nan
300,187,113,2019-03-09,clear-day,nan
1566,619,947,2019-05-23,partly-cloudy-day,nan
2225,831,1394,2019-08-18,partly-cloudy-day,nan
1913,860,1053,2019-09-09,partly-cloudy-day,nan
771,350,421,2019-10-31,cloudy,Halloween
92,91,1,2019-10-16,rain,nan
2293,1034,1259,2019-08-05,partly-cloudy-day,nan
1647,725,922,2019-09-24,partly-cloudy-day,nan
94,46,48,2019-05-05,rain,Cinco de Mayo
0,0,0,2019-09-04,partly-cloudy-night,nan
0,0,0,2019-06-10,clear-night,nan
2,0,2,2019-01-23,clear-night,nan
2452,1179,1273,2019-08-09,partly-cloudy-day,nan
2,0,2,2019-09-20,clear-night,nan
1,0,1,2019-11-29,clear-night,Black Friday
0,0,0,2019-11-22,partly-cloudy-night,nan
16,14,2,2019-04-20,rain,nan
602,220,382,2019-08-07,cloudy,nan
2229,960,1269,2019-08-02,partly-cloudy-day,nan
0,0,0,2019-10-14,cloudy,Columbus Day (regional holiday)
468,264,204,2019-09-01,partly-cloudy-day,nan
1736,722,1014,2019-10-17,cloudy,nan
1340,547,793,2019-02-09,clear-day,nan
19,10,9,2019-04-21,clear-night,Easter Monday
415,415,0,2019-02-19,clear-day,nan
1,0,1,2019-10-24,clear-night,nan
0,0,0,2019-02-02,clear-night,nan
0,0,0,2019-02-03,clear-night,nan
772,357,415,2019-06-16,partly-cloudy-day,nan
665,372,293,2019-01-25,partly-cloudy-day,nan
894,487,407,2019-04-08,cloudy,nan
0,0,0,2019-03-25,cloudy,nan
1298,618,680,2019-09-02,rain,Labor Day
0,0,0,2019-06-03,partly-cloudy-night,nan
1297,617,680,2019-06-29,partly-cloudy-day,nan
34,33,1,2019-04-11,cloudy,nan
914,512,402,2019-04-16,clear-day,nan
687,366,321,2019-12-26,partly-cloudy-day,nan
794,394,400,2019-01-28,clear-day,nan
1,0,1,2019-10-25,clear-night,nan
0,0,0,2019-01-30,clear-night,nan
17,17,0,2019-12-29,rain,nan
6,4,2,2019-02-07,rain,nan
202,141,61,2019-10-22,rain,nan
2675,1194,1481,2019-11-10,partly-cloudy-day,nan
3,0,3,2019-07-28,clear-night,nan
0,0,0,2019-03-14,partly-cloudy-night,nan
1111,577,534,2019-11-22,partly-cloudy-day,nan
1628,869,759,2019-07-10,partly-cloudy-day,nan
2866,1285,1581,2019-09-28,partly-cloudy-day,nan
1713,668,1045,2019-11-15,clear-day,nan
0,0,0,2019-11-07,clear-night,nan
1250,601,649,2019-02-08,partly-cloudy-day,nan
18,12,6,2019-05-02,cloudy,nan
2,0,2,2019-12-10,cloudy,nan
1607,715,892,2019-07-09,clear-day,nan
3316,1522,1794,2019-06-08,clear-day,nan
455,259,196,2019-10-26,clear-day,nan
830,450,380,2019-03-30,partly-cloudy-day,nan
1,0,1,2019-04-04,clear-night,nan
216,111,105,2019-03-31,partly-cloudy-day,nan
2273,905,1368,2019-11-29,clear-day,Black Friday
4,3,1,2019-09-16,clear-night,nan
74,63,11,2019-09-29,clear-night,nan
104,90,14,2019-02-07,cloudy,nan
0,0,0,2019-07-25,partly-cloudy-night,nan
57,43,14,2019-02-23,clear-night,nan
2014,821,1193,2019-10-15,clear-day,nan
263,158,105,2019-03-21,cloudy,nan
507,300,207,2019-01-13,partly-cloudy-day,nan
5,3,2,2019-12-09,rain,nan
2912,1204,1708,2019-08-25,partly-cloudy-day,nan
494,170,324,2019-09-23,partly-cloudy-day,nan
376,162,214,2019-05-03,cloudy,nan
132,59,73,2019-02-17,clear-day,nan
2553,1247,1306,2019-04-24,clear-day,nan
906,419,487,2019-03-10,cloudy,Daylight Saving Time starts
0,0,0,2019-01-18,cloudy,nan
1,0,1,2019-12-14,rain,nan
2163,1029,1134,2019-06-02,partly-cloudy-day,nan
972,443,529,2019-10-16,cloudy,nan
477,234,243,2019-03-25,partly-cloudy-day,nan
2508,1092,1416,2019-10-04,partly-cloudy-day,nan
0,0,0,2019-02-10,clear-night,nan
8,5,3,2019-02-01,clear-night,nan
1764,926,838,2019-06-04,clear-day,nan
8,7,1,2019-03-13,cloudy,nan
0,0,0,2019-08-25,partly-cloudy-night,nan
0,0,0,2019-12-07,clear-night,nan
0,0,0,2019-09-21,clear-night,nan
42,30,12,2019-08-10,clear-night,nan
61,56,5,2019-12-13,rain,nan
9,5,4,2019-03-04,cloudy,nan
0,0,0,2019-02-22,clear-night,nan
74,61,13,2019-01-26,partly-cloudy-night,nan
1372,657,715,2019-03-15,partly-cloudy-day,nan
2458,1302,1156,2019-08-17,cloudy,nan
49,43,6,2019-07-24,partly-cloudy-night,nan
1584,677,907,2019-04-11,cloudy,nan
1929,1059,870,2019-05-11,partly-cloudy-day,nan
61,45,16,2019-09-07,partly-cloudy-night,nan
1,0,1,2019-09-10,partly-cloudy-night,nan
952,576,376,2019-08-27,partly-cloudy-day,nan
2490,1071,1419,2019-10-21,clear-day,nan
0,0,0,2019-06-22,clear-night,nan
1,0,1,2019-08-19,partly-cloudy-night,nan
0,0,0,2019-01-18,cloudy,nan
0,0,0,2019-09-29,clear-night,nan
1556,542,1014,2019-04-22,cloudy,Easter Monday
1362,679,683,2019-04-01,clear-day,nan
0,0,0,2019-07-16,clear-night,nan
179,87,92,2019-01-22,clear-day,nan
119,46,73,2019-07-06,partly-cloudy-day,nan
3,0,3,2019-12-27,cloudy,nan
0,0,0,2019-09-26,clear-night,nan
41,21,20,2019-07-15,clear-night,nan
91,54,37,2019-02-17,cloudy,nan
0,0,0,2019-03-15,clear-night,nan
2863,1369,1494,2019-04-06,clear-day,nan
0,0,0,2019-01-18,partly-cloudy-night,nan
1931,943,988,2019-07-02,partly-cloudy-day,nan
6,0,6,2019-11-12,clear-night,nan
0,0,0,2019-09-09,partly-cloudy-night,nan
6,0,6,2019-07-23,rain,nan
1838,872,966,2019-04-10,clear-day,nan
3,2,1,2019-05-02,nan,nan
0,0,0,2019-03-12,partly-cloudy-night,nan
24,11,13,2019-12-04,cloudy,nan
43,39,4,2019-11-24,cloudy,nan
5,3,2,2019-08-31,clear-night,nan
1064,578,486,2019-03-12,clear-day,nan
2788,1274,1514,2019-03-23,clear-day,nan
2725,1215,1510,2019-04-17,partly-cloudy-day,nan
1500,780,720,2019-06-21,rain,nan
1284,628,656,2019-07-01,clear-day,nan
14,13,1,2019-02-15,partly-cloudy-night,nan
17,5,12,2019-05-20,clear-night,nan
38,27,11,2019-07-12,partly-cloudy-night,nan
438,227,211,2019-10-12,cloudy,nan
39,38,1,2019-04-04,clear-night,nan
131,67,64,2019-06-11,rain,nan
129,67,62,2019-04-05,rain,nan
1289,651,638,2019-03-26,clear-day,nan
3,2,1,2019-08-03,clear-night,nan
41,0,41,2019-10-25,clear-night,nan
641,318,323,2019-10-03,rain,nan
789,368,421,2019-03-31,cloudy,nan
0,0,0,2019-08-29,partly-cloudy-night,nan
1846,1005,841,2019-05-07,clear-day,nan
269,114,155,2019-08-12,partly-cloudy-day,nan
2226,1165,1061,2019-04-18,partly-cloudy-day,nan
40,0,40,2019-11-09,clear-night,nan
652,365,287,2019-10-01,cloudy,nan
1131,660,471,2019-12-22,clear-day,nan
1067,623,444,2019-07-11,clear-day,nan
266,182,84,2019-09-06,rain,nan
132,126,6,2019-11-07,rain,nan
1518,792,726,2019-12-08,clear-day,nan
2168,1140,1028,2019-05-16,partly-cloudy-day,nan
28,23,5,2019-04-24,clear-night,nan
167,68,99,2019-02-20,cloudy,nan
0,0,0,2019-08-16,partly-cloudy-night,nan
282,103,179,2019-02-04,clear-day,nan
366,154,212,2019-05-31,clear-day,nan
0,0,0,2019-10-07,cloudy,nan
1479,772,707,2019-09-16,cloudy,nan
0,0,0,2019-06-12,clear-night,nan
2,0,2,2019-12-30,rain,nan
3,0,3,2019-10-20,clear-night,nan
3,0,3,2019-07-23,cloudy,nan
21,14,7,2019-08-08,partly-cloudy-night,nan
2074,1033,1041,2019-08-18,partly-cloudy-day,nan
12,6,6,2019-01-07,partly-cloudy-night,nan
0,0,0,2019-10-29,cloudy,nan
2593,1399,1194,2019-05-26,clear-day,nan
497,233,264,2019-12-12,clear-day,nan
1380,570,810,2019-11-19,cloudy,nan
4,3,1,2019-12-01,cloudy,nan
5,0,5,2019-03-03,snow,nan
381,145,236,2019-01-02,partly-cloudy-day,nan
1,0,1,2019-10-26,partly-cloudy-night,nan
1436,871,565,2019-01-02,clear-day,nan
76,63,13,2019-11-23,clear-night,nan
23,20,3,2019-09-01,partly-cloudy-night,Labor Day
1652,734,918,2019-09-11,partly-cloudy-day,nan
0,0,0,2019-02-23,clear-night,nan
0,0,0,2019-01-07,clear-night,nan
25,12,13,2019-08-06,partly-cloudy-night,nan
266,110,156,2019-05-09,partly-cloudy-day,nan
1,0,1,2019-11-18,cloudy,nan
1397,614,783,2019-07-03,partly-cloudy-day,Independence Day
1,0,1,2019-04-18,cloudy,nan
442,162,280,2019-06-27,clear-day,nan
0,0,0,2019-07-04,partly-cloudy-night,nan
410,170,240,2019-03-14,partly-cloudy-night,nan
2227,1104,1123,2019-05-03,cloudy,nan
5,3,2,2019-01-12,clear-night,nan
754,433,321,2019-12-30,rain,nan
1011,405,606,2019-03-06,partly-cloudy-day,nan
39,16,23,2019-03-22,rain,nan
9,3,6,2019-06-16,cloudy,Father's Day
1,0,1,2019-10-02,partly-cloudy-night,nan
1,0,1,2019-10-11,cloudy,nan
2,1,1,2019-11-20,cloudy,nan
8,0,8,2019-12-04,cloudy,nan
10,5,5,2019-07-14,clear-night,nan
367,165,202,2019-09-06,partly-cloudy-day,nan
397,178,219,2019-07-30,clear-day,nan
121,52,69,2019-12-20,clear-night,nan
35,11,24,2019-01-02,cloudy,nan
1531,713,818,2019-02-05,clear-day,nan
1,0,1,2019-07-10,clear-night,nan
0,0,0,2019-10-20,cloudy,nan
99,88,11,2019-05-16,clear-night,nan
292,181,111,2019-01-07,partly-cloudy-night,nan
1,0,1,2019-09-18,clear-night,nan
6,5,1,2019-12-04,cloudy,nan
0,0,0,2019-07-03,cloudy,nan
62,61,1,2019-12-24,clear-night,Christmas Day
911,392,519,2019-11-13,clear-day,nan
4,2,2,2019-09-08,partly-cloudy-night,nan
0,0,0,2019-02-01,clear-night,nan
1,0,1,2019-11-09,clear-night,nan
3,0,3,2019-05-18,partly-cloudy-night,nan
0,0,0,2019-01-12,partly-cloudy-day,nan
2274,1014,1260,2019-01-03,partly-cloudy-day,nan
1827,872,955,2019-08-22,partly-cloudy-day,nan
48,23,25,2019-07-19,clear-night,nan
2100,855,1245,2019-09-27,clear-day,nan
1893,1071,822,2019-04-19,partly-cloudy-day,nan
1262,660,602,2019-06-05,partly-cloudy-day,nan
1337,665,672,2019-03-26,clear-day,nan
1,0,1,2019-02-24,rain,nan
0,0,0,2019-11-15,clear-night,nan
1680,744,936,2019-06-30,partly-cloudy-day,nan
1973,930,1043,2019-05-21,clear-day,nan
1324,542,782,2019-03-08,clear-day,nan
5,1,4,2019-06-12,clear-night,nan
10,8,2,2019-09-26,clear-night,nan
23,16,7,2019-06-09,clear-night,nan
2107,1083,1024,2019-05-27,clear-day,Memorial Day
673,398,275,2019-10-30,cloudy,nan
3214,1530,1684,2019-10-26,partly-cloudy-day,nan
63,46,17,2019-04-24,clear-night,nan
11,9,2,2019-09-05,clear-night,nan
1,0,1,2019-07-29,rain,nan
2514,1088,1426,2019-07-07,partly-cloudy-day,nan
11,6,5,2019-01-24,partly-cloudy-night,nan
1579,820,759,2019-07-10,partly-cloudy-day,nan
13,13,0,2019-06-08,clear-night,nan
190,84,106,2019-11-28,cloudy,Thanksgiving Day
1,0,1,2019-09-03,partly-cloudy-night,nan
259,96,163,2019-08-01,partly-cloudy-day,nan
1838,801,1037,2019-11-04,clear-day,nan
2,0,2,2019-11-26,clear-night,nan
1407,649,758,2019-09-30,cloudy,nan
1746,807,939,2019-09-17,clear-day,nan
1939,869,1070,2019-07-01,partly-cloudy-day,nan
740,387,353,2019-01-08,cloudy,nan
28,19,9,2019-08-19,partly-cloudy-night,nan
200,149,51,2019-01-29,cloudy,nan
1,0,1,2019-09-07,cloudy,nan
108,47,61,2019-01-13,cloudy,nan
2130,917,1213,2019-05-10,partly-cloudy-day,nan
1,0,1,2019-12-30,rain,nan
1239,694,545,2019-05-17,clear-day,nan
192,109,83,2019-06-27,clear-night,nan
373,135,238,2019-11-21,clear-day,nan
556,190,366,2019-01-01,partly-cloudy-night,New Year's Day
2128,816,1312,2019-10-24,clear-day,nan
269,127,142,2019-08-24,partly-cloudy-day,nan
2270,1033,1237,2019-06-03,partly-cloudy-day,nan
748,378,370,2019-06-17,cloudy,nan
16,9,7,2019-12-13,cloudy,nan
1,0,1,2019-06-04,clear-night,nan
1608,756,852,2019-01-19,cloudy,nan
2702,1186,1516,2019-09-28,partly-cloudy-day,nan
1,0,1,2019-08-27,partly-cloudy-night,nan
4,1,3,2019-07-07,partly-cloudy-night,nan
0,0,0,2019-09-10,cloudy,nan
28,22,6,2019-08-28,rain,nan
1479,686,793,2019-09-25,partly-cloudy-day,nan
1495,710,785,2019-05-01,cloudy,nan
42,21,21,2019-02-27,cloudy,nan
1052,420,632,2019-07-11,rain,nan
2700,1166,1534,2019-10-28,cloudy,nan
1785,800,985,2019-11-26,clear-day,nan
167,47,120,2019-07-01,partly-cloudy-night,nan
62,32,30,2019-11-12,partly-cloudy-night,nan
0,0,0,2019-04-16,clear-night,nan
2,0,2,2019-01-07,clear-night,nan
1548,662,886,2019-05-22,clear-day,nan
0,0,0,2019-11-04,clear-night,nan
0,0,0,2019-04-10,partly-cloudy-night,nan
2916,1314,1602,2019-07-05,partly-cloudy-day,nan
6,1,5,2019-08-14,cloudy,nan
18,16,2,2019-03-09,clear-night,nan
14,6,8,2019-10-02,cloudy,nan
2,0,2,2019-07-30,clear-night,nan
816,395,421,2019-01-16,cloudy,nan
366,181,185,2019-01-31,clear-day,nan
171,93,78,2019-08-22,partly-cloudy-night,nan
611,333,278,2019-08-07,partly-cloudy-day,nan
249,104,145,2019-05-20,partly-cloudy-day,nan
219,100,119,2019-05-12,rain,Mother's Day
1,0,1,2019-04-05,clear-night,nan
1,0,1,2019-01-26,clear-night,nan
5,0,5,2019-12-20,clear-night,nan
260,96,164,2019-01-25,cloudy,nan
354,139,215,2019-05-28,partly-cloudy-day,nan
0,0,0,2019-02-18,cloudy,Presidents' Day (regional holiday)
81,65,16,2019-09-13,partly-cloudy-night,nan
1373,790,583,2019-07-19,cloudy,nan
53,16,37,2019-12-09,rain,nan
20,9,11,2019-07-25,clear-night,nan
77,73,4,2019-11-05,clear-night,nan
0,0,0,2019-11-14,clear-night,nan
1022,624,398,2019-08-26,partly-cloudy-day,nan
373,184,189,2019-11-24,rain,nan
419,173,246,2019-08-27,partly-cloudy-day,nan
287,154,133,2019-06-18,rain,nan
3220,1277,1943,2019-06-22,partly-cloudy-day,nan
0,0,0,2019-11-18,cloudy,nan
2057,1122,935,2019-10-26,clear-day,nan
1751,832,919,2019-05-21,clear-day,nan
2,2,0,2019-12-25,clear-night,Christmas Day
1863,1023,840,2019-09-17,clear-day,nan
0,0,0,2019-02-04,clear-night,nan
37,36,1,2019-11-30,clear-night,nan
49,15,34,2019-01-24,rain,nan
2128,978,1150,2019-06-16,partly-cloudy-day,Father's Day
737,369,368,2019-02-07,cloudy,nan
367,183,184,2019-11-23,clear-day,nan
1452,698,754,2019-02-10,partly-cloudy-day,nan
0,0,0,2019-05-22,clear-night,nan
153,66,87,2019-07-28,partly-cloudy-day,nan
230,147,83,2019-05-13,rain,nan
36,14,22,2019-06-05,partly-cloudy-night,nan
175,58,117,2019-01-08,cloudy,nan
863,441,422,2019-05-28,partly-cloudy-day,nan
149,61,88,2019-07-14,clear-day,nan
490,279,211,2019-03-18,clear-day,nan
480,267,213,2019-08-16,partly-cloudy-day,nan
1073,527,546,2019-10-31,cloudy,Halloween
328,162,166,2019-11-18,cloudy,nan
0,0,0,2019-11-13,clear-night,nan
191,68,123,2019-06-30,partly-cloudy-night,nan
1401,662,739,2019-06-27,clear-day,nan
0,0,0,2019-09-05,partly-cloudy-night,nan
3,2,1,2019-11-28,clear-night,Black Friday
7,2,5,2019-05-08,clear-night,nan
43,39,4,2019-11-27,cloudy,nan
2620,1172,1448,2019-04-24,clear-day,nan
1026,441,585,2019-01-18,cloudy,nan
1978,852,1126,2019-09-27,clear-day,nan
2944,1107,1837,2019-05-04,partly-cloudy-day,nan
4,3,1,2019-02-11,clear-night,nan
8,0,8,2019-01-29,cloudy,nan
188,101,87,2019-05-19,partly-cloudy-day,nan
2820,1287,1533,2019-09-28,partly-cloudy-day,nan
6,2,4,2019-06-07,clear-night,nan
8,6,2,2019-01-08,cloudy,nan
21,0,21,2019-03-21,cloudy,nan
211,155,56,2019-01-17,partly-cloudy-night,nan
0,0,0,2019-12-11,rain,nan
2637,1368,1269,2019-06-01,clear-day,nan
1953,1061,892,2019-05-15,partly-cloudy-day,nan
255,99,156,2019-03-27,clear-day,nan
0,0,0,2019-10-16,clear-night,nan
585,325,260,2019-06-13,cloudy,nan
0,0,0,2019-04-30,cloudy,nan
1380,713,667,2019-05-03,cloudy,nan
90,57,33,2019-11-15,clear-night,nan
31,20,11,2019-10-14,partly-cloudy-night,Columbus Day (regional holiday)
0,0,0,2019-08-17,cloudy,nan
1665,878,787,2019-04-03,clear-day,nan
3,0,3,2019-05-27,partly-cloudy-night,Memorial Day
372,190,182,2019-01-31,clear-day,nan
1,0,1,2019-10-17,cloudy,nan
1437,656,781,2019-03-20,clear-day,nan
26,11,15,2019-01-01,partly-cloudy-night,New Year's Day
405,227,178,2019-10-03,rain,nan
1580,803,777,2019-06-28,partly-cloudy-day,nan
138,60,78,2019-03-09,clear-day,nan
226,117,109,2019-03-16,partly-cloudy-day,nan
2682,1258,1424,2019-08-17,partly-cloudy-day,nan
104,41,63,2019-07-07,cloudy,nan
11,7,4,2019-02-27,cloudy,nan
63,18,45,2019-06-19,cloudy,nan
2418,1073,1345,2019-05-16,partly-cloudy-day,nan
82,38,44,2019-01-02,cloudy,nan
273,144,129,2019-11-09,clear-day,nan
2381,1141,1240,2019-10-14,clear-day,Columbus Day (regional holiday)
101,65,36,2019-09-29,clear-night,nan
2183,1020,1163,2019-06-08,partly-cloudy-day,nan
1180,610,570,2019-08-13,partly-cloudy-day,nan
235,118,117,2019-04-27,clear-day,nan
1308,563,745,2019-09-12,cloudy,nan
3,1,2,2019-05-16,partly-cloudy-night,nan
1648,708,940,2019-10-17,cloudy,nan
14,11,3,2019-04-27,partly-cloudy-night,nan
10,0,10,2019-09-21,clear-night,nan
0,0,0,2019-02-05,partly-cloudy-night,nan
3064,1375,1689,2019-05-27,partly-cloudy-day,Memorial Day
27,23,4,2019-02-16,clear-night,nan
35,33,2,2019-12-14,cloudy,nan
9,6,3,2019-04-16,clear-night,nan
1,0,1,2019-07-31,clear-night,nan
2977,1405,1572,2019-09-01,partly-cloudy-day,nan
168,71,97,2019-11-19,cloudy,nan
1154,660,494,2019-05-31,clear-day,nan
3639,1400,2239,2019-04-21,partly-cloudy-day,Easter Sunday
255,102,153,2019-06-23,clear-day,nan
629,363,266,2019-10-29,cloudy,nan
1756,784,972,2019-04-29,clear-day,nan
0,0,0,2019-12-17,rain,nan
14,13,1,2019-12-19,cloudy,nan
0,0,0,2019-04-02,clear-night,nan
1642,813,829,2019-12-24,clear-day,Christmas Eve
0,0,0,2019-02-02,clear-night,nan
4,2,2,2019-05-05,rain,Cinco de Mayo
1,0,1,2019-07-31,clear-night,nan
1197,541,656,2019-06-29,partly-cloudy-day,nan
17,17,0,2019-11-08,clear-night,nan
2454,1246,1208,2019-03-09,clear-day,nan
342,202,140,2019-10-22,rain,nan
29,17,12,2019-10-25,clear-night,nan
725,462,263,2019-08-02,partly-cloudy-day,nan
3594,1665,1929,2019-05-25,partly-cloudy-day,nan
2145,829,1316,2019-04-14,cloudy,nan
1609,855,754,2019-04-10,clear-day,nan
1764,766,998,2019-05-09,cloudy,nan
0,0,0,2019-01-12,cloudy,nan
0,0,0,2019-12-06,clear-night,nan
809,452,357,2019-09-04,partly-cloudy-day,nan
1,0,1,2019-10-28,cloudy,nan
1,0,1,2019-10-02,partly-cloudy-night,nan
6,6,0,2019-12-29,rain,nan
9,0,9,2019-03-15,clear-night,nan
1,0,1,2019-11-19,partly-cloudy-night,nan
0,0,0,2019-11-06,clear-night,nan
4,0,4,2019-03-10,cloudy,Daylight Saving Time starts
1499,736,763,2019-06-05,partly-cloudy-day,nan
588,275,313,2019-05-09,partly-cloudy-day,nan
1897,968,929,2019-06-06,partly-cloudy-day,nan
247,111,136,2019-03-22,rain,nan
1687,797,890,2019-09-05,partly-cloudy-day,nan
984,620,364,2019-06-14,partly-cloudy-day,nan
214,107,107,2019-07-25,partly-cloudy-day,nan
1234,658,576,2019-05-17,partly-cloudy-day,nan
138,84,54,2019-07-14,clear-night,nan
132,47,85,2019-10-16,rain,nan
922,575,347,2019-08-23,rain,nan
1,0,1,2019-05-17,partly-cloudy-night,nan
1801,971,830,2019-04-22,partly-cloudy-day,Easter Monday
2,1,1,2019-03-26,cloudy,nan
1185,609,576,2019-04-15,partly-cloudy-day,Tax Day
12,10,2,2019-04-18,partly-cloudy-night,nan
30,28,2,2019-02-27,cloudy,nan
452,189,263,2019-05-17,clear-day,nan
2,1,1,2019-07-20,clear-night,nan
1890,996,894,2019-06-21,partly-cloudy-day,nan
969,524,445,2019-09-06,cloudy,nan
908,478,430,2019-12-09,cloudy,nan
1353,570,783,2019-12-05,partly-cloudy-day,nan
0,0,0,2019-01-31,clear-night,nan
8,7,1,2019-12-28,partly-cloudy-night,nan
21,15,6,2019-08-31,clear-night,nan
1753,704,1049,2019-09-17,clear-day,nan
876,481,395,2019-02-06,clear-day,nan
672,386,286,2019-02-04,clear-day,nan
0,0,0,2019-01-25,cloudy,nan
290,127,163,2019-08-22,partly-cloudy-night,nan
398,157,241,2019-01-30,cloudy,nan
4,1,3,2019-06-18,partly-cloudy-night,nan
55,33,22,2019-07-16,clear-night,nan
808,426,382,2019-12-01,cloudy,nan
507,286,221,2019-12-29,cloudy,nan
6,4,2,2019-07-06,cloudy,nan
882,510,372,2019-10-21,clear-day,nan
0,0,0,2019-01-25,partly-cloudy-night,nan
6,1,5,2019-01-13,cloudy,nan
1809,816,993,2019-06-12,partly-cloudy-day,nan
195,189,6,2019-07-11,rain,nan
1107,575,532,2019-07-30,clear-day,nan
1689,761,928,2019-08-01,partly-cloudy-day,nan
4,4,0,2019-03-05,clear-night,nan
1,0,1,2019-11-17,cloudy,nan
25,14,11,2019-09-02,partly-cloudy-night,nan
56,48,8,2019-04-27,clear-night,nan
809,383,426,2019-05-05,rain,Cinco de Mayo
0,0,0,2019-02-09,clear-night,nan
618,338,280,2019-09-07,clear-day,nan
1031,524,507,2019-02-28,clear-day,nan
1735,866,869,2019-01-03,partly-cloudy-day,nan
0,0,0,2019-12-14,rain,nan
740,447,293,2019-08-01,partly-cloudy-day,nan
3,2,1,2019-05-25,partly-cloudy-night,nan
9,8,1,2019-01-05,clear-night,nan
425,226,199,2019-09-22,clear-day,nan
40,33,7,2019-12-07,clear-night,nan
1376,833,543,2019-10-15,clear-day,nan
601,187,414,2019-03-16,partly-cloudy-night,nan
3,2,1,2019-03-12,clear-night,nan
1,0,1,2019-12-31,cloudy,New Year's Eve
2352,958,1394,2019-05-30,partly-cloudy-day,nan
36,35,1,2019-04-10,clear-night,nan
372,224,148,2019-06-30,clear-day,nan
1858,834,1024,2019-12-24,clear-day,Christmas Eve
1,0,1,2019-10-27,partly-cloudy-night,nan
4,3,1,2019-11-28,clear-night,Thanksgiving Day
0,0,0,2019-04-24,partly-cloudy-night,nan
1,0,1,2019-05-31,partly-cloudy-night,nan
0,0,0,2019-12-04,partly-cloudy-night,nan
1978,896,1082,2019-07-02,partly-cloudy-day,nan
2395,1088,1307,2019-08-08,partly-cloudy-day,nan
11,5,6,2019-08-11,clear-night,nan
23,10,13,2019-10-03,rain,nan
4,3,1,2019-09-24,clear-night,nan
1108,490,618,2019-09-08,partly-cloudy-day,nan
202,94,108,2019-08-07,rain,nan
3,2,1,2019-03-23,clear-night,nan
219,106,113,2019-11-08,clear-day,nan
168,77,91,2019-07-11,partly-cloudy-day,nan
316,155,161,2019-07-27,clear-day,nan
721,428,293,2019-11-20,cloudy,nan
266,97,169,2019-03-05,clear-day,nan
829,347,482,2019-05-22,clear-day,nan
0,0,0,2019-06-11,rain,nan
0,0,0,2019-07-12,partly-cloudy-night,nan
763,438,325,2019-04-28,cloudy,nan
0,0,0,2019-11-23,clear-night,nan
1082,588,494,2019-08-28,cloudy,nan
100,49,51,2019-07-18,cloudy,nan
1447,736,711,2019-07-18,cloudy,nan
2208,1085,1123,2019-08-30,clear-day,nan
20,14,6,2019-02-16,clear-night,nan
217,104,113,2019-08-18,cloudy,nan
0,0,0,2019-01-12,partly-cloudy-night,nan
51,27,24,2019-10-10,cloudy,nan
0,0,0,2019-07-26,clear-night,nan
1074,513,561,2019-01-09,partly-cloudy-day,nan
309,122,187,2019-04-23,clear-day,nan
308,132,176,2019-02-22,clear-day,nan
0,0,0,2019-02-21,rain,nan
178,67,111,2019-07-29,clear-day,nan
413,221,192,2019-01-23,cloudy,nan
10,3,7,2019-03-04,snow,nan
948,470,478,2019-04-28,cloudy,nan
766,429,337,2019-11-22,rain,nan
42,40,2,2019-01-11,clear-night,nan
612,330,282,2019-10-07,cloudy,nan
14,12,2,2019-03-30,clear-night,nan
1251,527,724,2019-11-14,clear-day,nan
2274,1124,1150,2019-07-07,partly-cloudy-day,nan
2,1,1,2019-01-02,clear-night,nan
37,25,12,2019-10-21,clear-night,nan
11,6,5,2019-05-30,cloudy,nan
180,86,94,2019-05-04,cloudy,nan
9,3,6,2019-01-18,cloudy,nan
15,10,5,2019-05-14,rain,nan
1216,540,676,2019-08-19,partly-cloudy-day,nan
724,318,406,2019-01-27,partly-cloudy-day,nan
25,23,2,2019-12-02,cloudy,nan
1041,508,533,2019-03-01,cloudy,nan
0,0,0,2019-12-16,clear-night,nan
302,124,178,2019-05-15,clear-day,nan
252,150,102,2019-12-25,clear-day,Christmas Day
36,31,5,2019-11-21,clear-night,nan
0,0,0,2019-04-01,clear-night,nan
1,0,1,2019-06-27,partly-cloudy-night,nan
1937,946,991,2019-07-08,partly-cloudy-day,nan
2,1,1,2019-07-09,clear-night,nan
5,4,1,2019-01-03,partly-cloudy-night,nan
696,334,362,2019-09-06,cloudy,nan
106,46,60,2019-01-17,clear-night,nan
1724,890,834,2019-02-17,clear-day,nan
814,413,401,2019-10-28,partly-cloudy-night,nan
1,1,0,2019-06-08,clear-night,nan
1624,636,988,2019-12-13,cloudy,nan
1713,962,751,2019-03-04,partly-cloudy-day,nan
1,0,1,2019-08-05,partly-cloudy-night,nan
88,33,55,2019-07-06,partly-cloudy-night,nan
2831,1412,1419,2019-01-01,partly-cloudy-day,New Year's Day
0,0,0,2019-08-20,clear-night,nan
470,228,242,2019-04-02,clear-day,nan
1252,661,591,2019-03-16,partly-cloudy-day,nan
10,1,9,2019-05-06,partly-cloudy-night,nan
8,1,7,2019-07-29,clear-night,nan
0,0,0,2019-08-15,partly-cloudy-night,nan
2131,1004,1127,2019-12-22,clear-day,nan
16,8,8,2019-07-09,clear-night,nan
2004,935,1069,2019-03-11,clear-day,nan
1728,788,940,2019-01-19,cloudy,nan
389,152,237,2019-11-06,clear-day,nan
1708,1015,693,2019-07-27,partly-cloudy-day,nan
60,0,60,2019-12-04,partly-cloudy-night,nan
169,148,21,2019-06-07,clear-night,nan
13,12,1,2019-02-09,clear-night,nan
22,17,5,2019-05-10,partly-cloudy-night,nan
1893,1068,825,2019-07-29,partly-cloudy-day,nan
257,106,151,2019-06-06,partly-cloudy-day,nan
75,62,13,2019-01-16,partly-cloudy-night,nan
21,15,6,2019-01-03,cloudy,nan
43,33,10,2019-06-21,clear-night,nan
1630,721,909,2019-04-03,clear-day,nan
1,0,1,2019-10-28,clear-night,nan
6,5,1,2019-06-15,clear-night,nan
35,25,10,2019-01-24,partly-cloudy-night,nan
344,182,162,2019-10-27,rain,nan
10,5,5,2019-08-20,clear-night,nan
1421,595,826,2019-03-26,clear-day,nan
1303,736,567,2019-06-24,clear-day,nan
3,1,2,2019-09-24,rain,nan
833,420,413,2019-06-20,cloudy,nan
13,8,5,2019-04-07,partly-cloudy-night,nan
311,163,148,2019-09-24,partly-cloudy-night,nan
0,0,0,2019-03-13,clear-night,nan
0,0,0,2019-01-14,clear-night,nan
179,85,94,2019-08-02,partly-cloudy-day,nan
1945,997,948,2019-08-12,clear-day,nan
0,0,0,2019-12-23,clear-night,nan
3131,1583,1548,2019-04-06,clear-day,nan
1,1,0,2019-05-08,cloudy,nan
0,0,0,2019-10-17,cloudy,nan
0,0,0,2019-12-08,clear-night,nan
31,5,26,2019-08-16,cloudy,nan
1235,596,639,2019-07-19,partly-cloudy-day,nan
93,81,12,2019-09-22,clear-night,nan
1299,600,699,2019-05-01,cloudy,nan
2198,1132,1066,2019-07-28,partly-cloudy-day,nan
151,75,76,2019-06-05,partly-cloudy-day,nan
47,44,3,2019-10-30,cloudy,Halloween
5,4,1,2019-02-22,clear-night,nan
0,0,0,2019-04-07,clear-night,nan
2162,952,1210,2019-12-06,cloudy,nan
0,0,0,2019-02-27,cloudy,nan
766,306,460,2019-07-21,partly-cloudy-day,nan
161,81,80,2019-12-18,clear-night,nan
35,22,13,2019-05-09,clear-night,nan
2551,1162,1389,2019-07-13,partly-cloudy-day,nan
27,23,4,2019-10-05,clear-night,nan
0,0,0,2019-12-12,clear-night,nan
136,112,24,2019-12-09,rain,nan
971,393,578,2019-02-24,cloudy,nan
44,14,30,2019-06-01,partly-cloudy-night,nan
2019,994,1025,2019-11-29,clear-day,Black Friday
77,32,45,2019-06-21,rain,nan
0,0,0,2019-10-06,cloudy,nan
1188,626,562,2019-01-26,partly-cloudy-day,nan
1,0,1,2019-09-04,partly-cloudy-night,nan
48,45,3,2019-11-10,partly-cloudy-night,Veterans Day
2266,1173,1093,2019-12-26,partly-cloudy-day,nan
0,0,0,2019-02-02,partly-cloudy-night,nan
236,123,113,2019-11-17,cloudy,nan
0,0,0,2019-09-30,partly-cloudy-night,nan
0,0,0,2019-08-22,partly-cloudy-night,nan
1,0,1,2019-06-02,clear-night,nan
1,0,1,2019-09-02,partly-cloudy-night,Labor Day
3,0,3,2019-06-03,clear-night,nan
377,182,195,2019-12-10,rain,nan
981,583,398,2019-06-20,partly-cloudy-day,nan
647,334,313,2019-11-18,cloudy,nan
0,0,0,2019-01-07,clear-night,nan
17,16,1,2019-12-23,clear-night,Christmas Eve
2114,955,1159,2019-05-19,partly-cloudy-day,nan
2,0,2,2019-04-25,clear-night,nan
194,84,110,2019-06-22,clear-night,nan
1834,872,962,2019-06-23,clear-day,nan
959,442,517,2019-05-14,cloudy,nan
3,0,3,2019-12-28,clear-night,nan
1,0,1,2019-08-11,clear-night,nan
1,0,1,2019-08-09,partly-cloudy-night,nan
137,87,50,2019-01-30,cloudy,nan
1522,695,827,2019-06-26,clear-day,nan
2394,1029,1365,2019-06-02,partly-cloudy-day,nan
1344,689,655,2019-03-19,partly-cloudy-day,nan
1250,664,586,2019-06-25,partly-cloudy-day,nan
30,8,22,2019-01-21,clear-night,Martin Luther King Jr. Day
1,0,1,2019-03-10,cloudy,Daylight Saving Time starts
0,0,0,2019-11-25,clear-night,nan
2104,998,1106,2019-07-14,partly-cloudy-day,nan
225,93,132,2019-05-03,cloudy,nan
275,158,117,2019-10-19,clear-night,nan
2,0,2,2019-05-06,cloudy,nan
23,9,14,2019-07-20,clear-night,nan
0,0,0,2019-03-14,cloudy,nan
1,0,1,2019-10-11,partly-cloudy-night,nan
11,10,1,2019-12-15,partly-cloudy-night,nan
190,92,98,2019-11-30,clear-night,nan
122,46,76,2019-07-03,partly-cloudy-night,Independence Day
878,443,435,2019-09-11,clear-day,nan
154,83,71,2019-12-26,partly-cloudy-night,nan
0,0,0,2019-02-14,cloudy,Valentine's Day
1,0,1,2019-02-16,clear-night,nan
2188,970,1218,2019-09-20,clear-day,nan
0,0,0,2019-10-24,clear-night,nan
0,0,0,2019-05-20,rain,nan
175,52,123,2019-05-30,cloudy,nan
1629,727,902,2019-07-10,partly-cloudy-day,nan
20,8,12,2019-07-31,partly-cloudy-night,nan
425,235,190,2019-12-31,cloudy,New Year's Eve
40,0,40,2019-12-20,clear-night,nan
1759,849,910,2019-02-21,partly-cloudy-day,nan
0,0,0,2019-03-25,cloudy,nan
16,13,3,2019-12-12,clear-night,nan
2424,1203,1221,2019-08-03,partly-cloudy-day,nan
45,36,9,2019-11-28,partly-cloudy-night,Thanksgiving Day
875,425,450,2019-02-25,partly-cloudy-day,nan
0,0,0,2019-10-05,clear-night,nan
1127,519,608,2019-07-18,cloudy,nan
2130,974,1156,2019-10-23,clear-day,nan
2,2,0,2019-05-11,cloudy,nan
4,2,2,2019-01-03,cloudy,nan
1048,491,557,2019-04-12,cloudy,nan
12,8,4,2019-04-25,cloudy,nan
0,0,0,2019-11-27,clear-night,nan
165,69,96,2019-08-05,partly-cloudy-night,nan
1220,597,623,2019-04-25,cloudy,nan
12,6,6,2019-08-05,clear-night,nan
0,0,0,2019-05-24,clear-night,nan
2052,893,1159,2019-06-07,partly-cloudy-day,nan
174,112,62,2019-12-14,cloudy,nan
15,0,15,2019-11-21,partly-cloudy-night,nan
1992,1218,774,2019-08-10,clear-day,nan
243,144,99,2019-05-26,partly-cloudy-day,nan
220,137,83,2019-01-20,rain,nan
2704,1207,1497,2019-10-04,partly-cloudy-day,nan
10,0,10,2019-12-02,cloudy,nan
1623,745,878,2019-03-27,clear-day,nan
0,0,0,2019-11-03,clear-night,Daylight Saving Time ends
1238,613,625,2019-02-15,cloudy,nan
1,0,1,2019-06-04,clear-night,nan
3,0,3,2019-01-14,clear-night,nan
0,0,0,2019-06-19,cloudy,nan
2556,1327,1229,2019-04-23,clear-day,nan
1961,867,1094,2019-11-16,clear-day,nan
2203,999,1204,2019-08-26,partly-cloudy-day,nan
1,0,1,2019-08-16,partly-cloudy-night,nan
18,0,18,2019-11-08,cloudy,nan
2385,1208,1177,2019-10-25,partly-cloudy-day,nan
2712,1175,1537,2019-06-09,clear-day,nan
87,50,37,2019-04-01,clear-night,nan
1732,853,879,2019-08-19,partly-cloudy-day,nan
2339,923,1416,2019-10-04,partly-cloudy-day,nan
1227,523,704,2019-11-07,cloudy,nan
1533,702,831,2019-03-15,partly-cloudy-day,nan
658,395,263,2019-02-15,cloudy,nan
24,0,24,2019-01-10,partly-cloudy-night,nan
1618,856,762,2019-05-31,partly-cloudy-day,nan
1,0,1,2019-11-10,partly-cloudy-night,Veterans Day
0,0,0,2019-05-30,cloudy,nan
752,519,233,2019-04-13,cloudy,nan
0,0,0,2019-12-09,rain,nan
205,66,139,2019-07-22,partly-cloudy-day,nan
0,0,0,2019-03-21,partly-cloudy-night,nan
4,3,1,2019-11-16,clear-night,nan
29,0,29,2019-12-21,clear-night,nan
108,52,56,2019-02-08,cloudy,nan
2549,1127,1422,2019-04-17,partly-cloudy-day,nan
404,233,171,2019-07-13,clear-day,nan
2596,1202,1394,2019-06-01,partly-cloudy-day,nan
0,0,0,2019-09-13,partly-cloudy-night,nan
1505,709,796,2019-02-03,clear-day,nan
889,434,455,2019-01-08,cloudy,nan
3,0,3,2019-08-27,partly-cloudy-night,nan
3650,1896,1754,2019-12-27,cloudy,nan
108,107,1,2019-10-19,clear-night,nan
6,5,1,2019-04-12,cloudy,nan
34,31,3,2019-11-23,clear-night,nan
95,40,55,2019-05-23,rain,nan
1,0,1,2019-06-28,clear-night,nan
457,179,278,2019-09-18,partly-cloudy-day,nan
1039,549,490,2019-02-22,partly-cloudy-day,nan
0,0,0,2019-12-22,clear-night,nan
152,50,102,2019-01-30,clear-day,nan
33,14,19,2019-08-03,partly-cloudy-night,nan
10,7,3,2019-10-22,cloudy,nan
21,11,10,2019-09-30,cloudy,nan
56,50,6,2019-09-21,clear-night,nan
38,27,11,2019-09-07,clear-night,nan
3140,1327,1813,2019-05-18,clear-day,nan
1,0,1,2019-08-30,clear-night,nan
77,0,77,2019-11-12,clear-night,nan
156,86,70,2019-10-09,rain,nan
697,337,360,2019-05-09,cloudy,nan
5,0,5,2019-03-03,partly-cloudy-night,nan
4,1,3,2019-04-14,partly-cloudy-night,nan
1128,605,523,2019-02-09,clear-day,nan
1387,597,790,2019-09-23,clear-day,nan
63,60,3,2019-12-08,clear-night,nan
3430,1636,1794,2019-05-18,clear-day,nan
43,41,2,2019-11-30,clear-night,nan
837,440,397,2019-12-16,cloudy,nan
1737,728,1009,2019-05-29,cloudy,nan
7,2,5,2019-03-10,sleet,Daylight Saving Time starts
1800,805,995,2019-07-23,cloudy,nan
1238,710,528,2019-05-20,partly-cloudy-day,nan
65,63,2,2019-11-01,clear-night,nan
0,0,0,2019-11-05,clear-night,nan
1476,500,976,2019-10-20,cloudy,nan
403,169,234,2019-08-15,partly-cloudy-day,nan
152,69,83,2019-06-26,partly-cloudy-night,nan
0,0,0,2019-02-21,rain,nan
640,326,314,2019-11-24,cloudy,nan
5,1,4,2019-04-18,partly-cloudy-night,nan
892,424,468,2019-03-31,rain,nan
11,3,8,2019-06-04,partly-cloudy-night,nan
943,564,379,2019-08-21,partly-cloudy-day,nan
111,57,54,2019-04-09,cloudy,nan
64,54,10,2019-11-19,cloudy,nan
2746,1153,1593,2019-04-07,clear-day,nan
0,0,0,2019-12-15,clear-night,nan
9,5,4,2019-07-04,clear-day,Independence Day
980,454,526,2019-02-26,clear-day,nan
797,329,468,2019-01-15,clear-day,nan
65,65,0,2019-12-12,clear-night,nan
2568,1112,1456,2019-09-08,partly-cloudy-day,nan
0,0,0,2019-05-13,cloudy,nan
34,29,5,2019-09-18,clear-night,nan
1285,594,691,2019-12-10,cloudy,nan
2042,1014,1028,2019-08-23,partly-cloudy-day,nan
2044,1064,980,2019-09-19,clear-day,nan
453,176,277,2019-03-11,clear-night,nan
739,341,398,2019-01-23,cloudy,nan
1531,689,842,2019-08-20,clear-day,nan
1479,649,830,2019-08-21,cloudy,nan
1271,545,726,2019-11-19,cloudy,nan
2166,972,1194,2019-01-04,clear-day,nan
231,114,117,2019-11-08,clear-night,nan
2,0,2,2019-05-28,clear-night,nan
34,21,13,2019-09-29,clear-night,nan
1020,472,548,2019-01-07,partly-cloudy-day,nan
2,1,1,2019-01-29,clear-night,nan
0,0,0,2019-09-10,partly-cloudy-night,nan
1775,885,890,2019-04-15,partly-cloudy-day,Tax Day
27,25,2,2019-02-01,clear-night,nan
61,57,4,2019-02-10,partly-cloudy-night,nan
1594,741,853,2019-09-10,cloudy,nan
0,0,0,2019-11-30,partly-cloudy-night,nan
654,339,315,2019-10-02,partly-cloudy-day,nan
0,0,0,2019-01-26,clear-night,nan
19,16,3,2019-10-26,clear-night,nan
34,33,1,2019-12-17,rain,nan
355,355,0,2019-02-19,clear-night,nan
648,351,297,2019-11-11,clear-day,Veterans Day
42,41,1,2019-09-14,partly-cloudy-night,nan
1365,636,729,2019-12-18,clear-day,nan
1612,865,747,2019-04-08,partly-cloudy-day,nan
1765,695,1070,2019-07-16,partly-cloudy-day,nan
150,78,72,2019-06-03,clear-day,nan
2420,1156,1264,2019-11-10,cloudy,nan
0,0,0,2019-12-02,rain,nan
7,4,3,2019-09-27,clear-night,nan
1936,855,1081,2019-03-28,clear-day,nan
576,234,342,2019-04-09,partly-cloudy-day,nan
3,2,1,2019-09-09,cloudy,nan
138,70,68,2019-04-07,clear-day,nan
22,12,10,2019-05-10,cloudy,nan
1,0,1,2019-04-16,clear-night,nan
1165,455,710,2019-09-02,rain,Labor Day
1794,722,1072,2019-07-19,partly-cloudy-day,nan
36,19,17,2019-01-08,cloudy,nan
1,0,1,2019-11-05,clear-night,nan
349,184,165,2019-02-20,partly-cloudy-day,nan
20,9,11,2019-12-17,rain,nan
981,539,442,2019-04-24,clear-day,nan
3,2,1,2019-10-08,partly-cloudy-night,nan
186,86,100,2019-03-30,cloudy,nan
232,95,137,2019-07-31,clear-day,nan
1748,892,856,2019-05-20,partly-cloudy-day,nan
0,0,0,2019-12-19,clear-night,nan
2207,1025,1182,2019-06-30,partly-cloudy-day,nan
32,31,1,2019-12-11,clear-night,nan
764,340,424,2019-02-07,cloudy,nan
22,11,11,2019-01-17,cloudy,nan
818,305,513,2019-04-22,cloudy,Easter Monday
7,2,5,2019-07-16,clear-night,nan
465,142,323,2019-08-03,partly-cloudy-day,nan
1397,773,624,2019-09-10,cloudy,nan
0,0,0,2019-08-06,partly-cloudy-night,nan
15,7,8,2019-10-01,clear-night,nan
86,53,33,2019-11-10,cloudy,nan
630,333,297,2019-07-25,clear-day,nan
22,17,5,2019-10-17,partly-cloudy-night,nan
0,0,0,2019-01-08,cloudy,nan
1395,741,654,2019-02-04,clear-day,nan
1,0,1,2019-12-03,clear-night,nan
1509,700,809,2019-11-27,cloudy,nan
110,74,36,2019-01-05,cloudy,nan
3,1,2,2019-06-26,partly-cloudy-night,nan
229,115,114,2019-01-29,cloudy,nan
312,164,148,2019-11-13,clear-day,nan
2046,965,1081,2019-06-16,partly-cloudy-day,Father's Day
222,108,114,2019-06-01,clear-day,nan
2105,1059,1046,2019-04-16,clear-day,nan
79,47,32,2019-11-21,clear-night,nan
0,0,0,2019-03-19,clear-night,nan
0,0,0,2019-11-10,partly-cloudy-night,nan
1220,512,708,2019-02-28,clear-day,nan
40,36,4,2019-09-20,clear-night,nan
2047,952,1095,2019-10-10,partly-cloudy-day,nan
276,131,145,2019-08-25,partly-cloudy-day,nan
581,264,317,2019-10-03,rain,nan
1438,879,559,2019-07-07,partly-cloudy-day,nan
1030,515,515,2019-02-23,partly-cloudy-day,nan
79,44,35,2019-04-14,partly-cloudy-night,nan
1835,868,967,2019-05-16,partly-cloudy-day,nan
1,0,1,2019-01-10,cloudy,nan
2,0,2,2019-07-02,clear-night,nan
0,0,0,2019-10-25,clear-night,nan
627,318,309,2019-03-31,cloudy,nan
3,1,2,2019-04-21,partly-cloudy-night,Easter Sunday
1240,685,555,2019-11-15,clear-day,nan
223,137,86,2019-05-12,rain,Mother's Day
31,30,1,2019-04-03,clear-night,nan
55,46,9,2019-06-08,clear-night,nan
1389,712,677,2019-08-18,partly-cloudy-day,nan
25,0,25,2019-03-28,clear-night,nan
0,0,0,2019-01-12,partly-cloudy-day,nan
383,134,249,2019-10-16,cloudy,nan
48,32,16,2019-05-15,cloudy,nan
98,56,42,2019-04-03,clear-night,nan
0,0,0,2019-12-30,rain,nan
243,116,127,2019-04-10,clear-day,nan
52,27,25,2019-04-20,rain,nan
2032,1124,908,2019-09-15,partly-cloudy-day,nan
1649,793,856,2019-08-07,partly-cloudy-day,nan
28,26,2,2019-10-22,rain,nan
1023,499,524,2019-06-06,partly-cloudy-day,nan
1607,659,948,2019-04-11,partly-cloudy-day,nan
2031,1026,1005,2019-08-01,partly-cloudy-day,nan
9,8,1,2019-03-20,clear-night,nan
33,15,18,2019-04-14,cloudy,Tax Day
644,262,382,2019-05-05,rain,Cinco de Mayo
10,0,10,2019-08-19,clear-night,nan
0,0,0,2019-02-02,partly-cloudy-day,nan
2094,886,1208,2019-05-07,partly-cloudy-day,nan
37,19,18,2019-04-20,partly-cloudy-night,Easter Sunday
52,21,31,2019-08-10,clear-night,nan
10,0,10,2019-12-05,partly-cloudy-night,nan
9,7,2,2019-05-28,partly-cloudy-night,nan
32,30,2,2019-04-11,cloudy,nan
775,462,313,2019-06-29,partly-cloudy-day,nan
487,260,227,2019-11-22,partly-cloudy-day,nan
1328,722,606,2019-11-26,clear-day,nan
1319,678,641,2019-09-26,clear-day,nan
2366,1104,1262,2019-02-16,clear-day,nan
3450,1445,2005,2019-09-01,partly-cloudy-day,nan
2090,939,1151,2019-07-12,partly-cloudy-day,nan
1118,444,674,2019-03-07,cloudy,nan
2205,971,1234,2019-11-23,clear-day,nan
29,22,7,2019-03-17,partly-cloudy-night,St. Patrick's Day
0,0,0,2019-09-27,clear-night,nan
0,0,0,2019-02-12,cloudy,nan
724,384,340,2019-01-18,cloudy,nan
2,0,2,2019-09-14,partly-cloudy-night,nan
117,59,58,2019-06-14,clear-night,nan
386,202,184,2019-04-26,rain,nan
2,1,1,2019-09-17,partly-cloudy-night,nan
112,104,8,2019-05-17,partly-cloudy-night,nan
31,26,5,2019-09-28,partly-cloudy-night,nan
500,281,219,2019-12-03,partly-cloudy-day,nan
29,29,0,2019-10-11,partly-cloudy-night,nan
1869,951,918,2019-06-03,partly-cloudy-day,nan
416,221,195,2019-01-04,clear-day,nan
1282,543,739,2019-03-05,clear-day,nan
0,0,0,2019-07-21,clear-night,nan
2750,1364,1386,2019-05-27,clear-day,Memorial Day
2242,1033,1209,2019-06-07,clear-day,nan
0,0,0,2019-12-10,cloudy,nan
0,0,0,2019-05-02,fog,nan
1205,655,550,2019-11-04,clear-day,nan
758,386,372,2019-05-23,partly-cloudy-day,nan
716,350,366,2019-02-13,snow,nan
0,0,0,2019-10-14,cloudy,Columbus Day (regional holiday)
0,0,0,2019-09-16,partly-cloudy-night,nan
3,0,3,2019-11-13,clear-night,nan
1398,626,772,2019-09-12,cloudy,nan
367,217,150,2019-01-31,clear-day,nan
2010,1203,807,2019-07-24,partly-cloudy-day,nan
1652,889,763,2019-07-15,clear-day,nan
1,0,1,2019-02-26,clear-night,nan
216,103,113,2019-12-05,partly-cloudy-night,nan
2255,1033,1222,2019-08-23,partly-cloudy-day,nan
14,6,8,2019-08-09,clear-night,nan
2496,1193,1303,2019-08-31,partly-cloudy-day,nan
0,0,0,2019-11-06,clear-night,nan
57,56,1,2019-12-28,partly-cloudy-night,nan
431,216,215,2019-11-02,clear-day,nan
596,280,316,2019-03-29,cloudy,nan
42,25,17,2019-09-01,partly-cloudy-night,Labor Day
135,61,74,2019-05-17,partly-cloudy-day,nan
560,282,278,2019-01-16,partly-cloudy-night,nan
0,0,0,2019-04-05,clear-night,nan
4,0,4,2019-03-08,clear-night,nan
40,26,14,2019-02-11,cloudy,nan
1509,790,719,2019-06-05,clear-day,nan
908,411,497,2019-02-11,cloudy,nan
0,0,0,2019-04-06,cloudy,nan
1274,641,633,2019-03-22,cloudy,nan
0,0,0,2019-05-04,cloudy,nan
1881,863,1018,2019-04-04,clear-day,nan
0,0,0,2019-03-04,snow,nan
0,0,0,2019-12-29,partly-cloudy-night,nan
14,12,2,2019-03-08,partly-cloudy-night,nan
990,562,428,2019-09-21,clear-day,nan
1727,893,834,2019-12-07,clear-day,nan
1738,646,1092,2019-04-06,clear-day,nan
824,390,434,2019-12-19,clear-day,nan
2358,1097,1261,2019-08-17,partly-cloudy-day,nan
801,364,437,2019-01-10,partly-cloudy-day,nan
66,55,11,2019-09-03,clear-night,nan
902,465,437,2019-07-11,rain,nan
1337,668,669,2019-05-10,partly-cloudy-day,nan
491,275,216,2019-10-31,rain,Halloween
3292,1674,1618,2019-05-25,partly-cloudy-day,nan
3,1,2,2019-09-03,partly-cloudy-night,nan
51,30,21,2019-03-06,clear-night,nan
24,23,1,2019-12-10,rain,nan
4,0,4,2019-01-16,clear-night,nan
159,61,98,2019-10-30,cloudy,nan
71,38,33,2019-01-19,cloudy,nan
118,79,39,2019-12-18,partly-cloudy-night,nan
0,0,0,2019-09-22,clear-night,nan
1,0,1,2019-01-04,clear-night,nan
110,61,49,2019-01-24,rain,nan
226,102,124,2019-01-01,partly-cloudy-night,New Year's Day
793,399,394,2019-03-13,clear-day,nan
3593,1479,2114,2019-10-12,clear-day,nan
1392,655,737,2019-07-30,partly-cloudy-day,nan
1475,765,710,2019-11-02,clear-day,nan
99,87,12,2019-07-20,clear-night,nan
324,139,185,2019-12-13,cloudy,nan
25,19,6,2019-04-22,partly-cloudy-night,Easter Monday
18,9,9,2019-12-02,rain,nan
3430,1538,1892,2019-10-19,clear-day,nan
1835,821,1014,2019-08-06,partly-cloudy-day,nan
2673,1419,1254,2019-06-22,partly-cloudy-day,nan
2374,1085,1289,2019-02-17,clear-day,nan
0,0,0,2019-01-11,clear-night,nan
1,0,1,2019-07-11,cloudy,nan
0,0,0,2019-03-30,cloudy,nan
1023,479,544,2019-12-11,cloudy,nan
235,124,111,2019-04-29,clear-day,nan
1919,1080,839,2019-08-22,partly-cloudy-day,nan
489,237,252,2019-03-15,partly-cloudy-night,nan
1941,918,1023,2019-05-03,cloudy,nan
2202,898,1304,2019-06-04,clear-day,nan
231,103,128,2019-01-31,clear-day,nan
2023,991,1032,2019-07-26,partly-cloudy-day,nan
19,9,10,2019-01-14,partly-cloudy-night,nan
254,113,141,2019-08-14,partly-cloudy-day,nan
1399,714,685,2019-10-30,cloudy,nan
1796,850,946,2019-05-03,cloudy,nan
1278,633,645,2019-06-25,cloudy,nan
1,0,1,2019-01-22,clear-night,nan
2311,1015,1296,2019-11-03,partly-cloudy-day,Daylight Saving Time ends
381,191,190,2019-07-12,partly-cloudy-day,nan
15,10,5,2019-10-28,partly-cloudy-night,nan
18,12,6,2019-05-14,cloudy,nan
744,348,396,2019-02-06,partly-cloudy-day,nan
2913,1441,1472,2019-01-02,partly-cloudy-day,nan
2,0,2,2019-01-28,clear-night,nan
2395,1013,1382,2019-08-11,partly-cloudy-day,nan
1273,638,635,2019-06-19,cloudy,nan
999,473,526,2019-02-13,rain,nan
0,0,0,2019-03-17,partly-cloudy-night,St. Patrick's Day
54,37,17,2019-08-01,partly-cloudy-night,nan
6,1,5,2019-01-19,clear-night,nan
1643,803,840,2019-08-19,partly-cloudy-day,nan
2,0,2,2019-06-23,clear-night,nan
1,0,1,2019-09-20,clear-night,nan
1307,542,765,2019-12-20,clear-day,nan
1944,1014,930,2019-07-14,clear-day,nan
2333,1055,1278,2019-04-27,clear-day,nan
136,106,30,2019-11-14,partly-cloudy-night,nan
3,1,2,2019-06-24,clear-night,nan
1764,1078,686,2019-09-14,cloudy,nan
0,0,0,2019-12-21,clear-night,nan
1294,643,651,2019-05-26,partly-cloudy-day,Memorial Day
2860,1072,1788,2019-05-11,partly-cloudy-day,nan
2,1,1,2019-01-05,rain,nan
1,0,1,2019-08-26,clear-night,nan
0,0,0,2019-11-08,clear-night,nan
5,0,5,2019-11-14,partly-cloudy-night,nan
1827,847,980,2019-01-26,partly-cloudy-day,nan
1156,586,570,2019-01-13,partly-cloudy-day,nan
0,0,0,2019-10-03,rain,nan
54,41,13,2019-02-16,clear-night,nan
1,1,0,2019-06-29,clear-night,nan
72,61,11,2019-08-13,cloudy,nan
2404,1054,1350,2019-09-15,clear-day,nan
0,0,0,2019-04-10,clear-night,nan
1774,852,922,2019-08-30,clear-day,nan
0,0,0,2019-01-12,partly-cloudy-night,nan
166,85,81,2019-07-02,clear-day,nan
2640,1340,1300,2019-12-23,clear-day,nan
641,405,236,2019-03-12,cloudy,nan
372,189,183,2019-05-13,rain,nan
1596,863,733,2019-05-08,clear-day,nan
1569,718,851,2019-05-01,cloudy,nan
1406,897,509,2019-05-30,cloudy,nan
442,179,263,2019-11-03,partly-cloudy-night,Daylight Saving Time ends
964,452,512,2019-01-09,partly-cloudy-day,nan
1794,876,918,2019-10-08,partly-cloudy-day,nan
1,0,1,2019-09-16,partly-cloudy-night,nan
4,3,1,2019-05-22,clear-night,nan
31,17,14,2019-09-06,cloudy,nan
2429,1116,1313,2019-11-09,clear-day,nan
120,84,36,2019-07-18,cloudy,nan
13,10,3,2019-10-21,clear-night,nan
960,433,527,2019-03-07,partly-cloudy-day,nan
23,22,1,2019-01-25,clear-night,nan
23,15,8,2019-08-23,rain,nan
1783,835,948,2019-04-30,cloudy,nan
233,85,148,2019-02-27,cloudy,nan
119,38,81,2019-07-07,partly-cloudy-night,nan
9,2,7,2019-03-01,cloudy,nan
0,0,0,2019-09-27,clear-night,nan
2264,1039,1225,2019-11-01,clear-day,nan
1453,580,873,2019-04-02,partly-cloudy-day,nan
2234,1017,1217,2019-07-06,partly-cloudy-day,nan
0,0,0,2019-06-21,cloudy,nan
0,0,0,2019-03-24,clear-night,nan
0,0,0,2019-11-19,rain,nan
1240,608,632,2019-10-29,cloudy,nan
1943,839,1104,2019-08-08,partly-cloudy-day,nan
192,112,80,2019-05-12,rain,Mother's Day
551,303,248,2019-02-24,cloudy,nan
45,43,2,2019-10-10,partly-cloudy-night,nan
4,2,2,2019-02-05,clear-night,nan
0,0,0,2019-03-28,clear-night,nan
2,2,0,2019-09-17,nan,nan
2071,1087,984,2019-12-23,clear-day,nan
1159,550,609,2019-07-02,partly-cloudy-day,nan
28,28,0,2019-02-18,clear-night,Presidents' Day (regional holiday)
2,1,1,2019-02-07,cloudy,nan
780,477,303,2019-10-18,partly-cloudy-day,nan
3,2,1,2019-05-25,clear-night,nan
1924,971,953,2019-03-11,clear-day,nan
2,1,1,2019-04-01,clear-night,nan
0,0,0,2019-05-15,cloudy,nan
362,158,204,2019-08-20,partly-cloudy-day,nan
1786,1006,780,2019-08-20,partly-cloudy-day,nan
24,8,16,2019-01-20,clear-night,nan
1877,826,1051,2019-04-28,partly-cloudy-day,nan
2029,879,1150,2019-10-12,partly-cloudy-day,nan
1989,840,1149,2019-07-15,clear-day,nan
1,0,1,2019-06-25,partly-cloudy-night,nan
0,0,0,2019-07-13,clear-night,nan
1,0,1,2019-08-02,partly-cloudy-night,nan
59,57,2,2019-02-03,partly-cloudy-night,nan
2,1,1,2019-04-01,clear-night,nan
0,0,0,2019-10-10,cloudy,nan
2479,1129,1350,2019-11-09,clear-day,nan
3,2,1,2019-01-17,clear-night,nan
2181,976,1205,2019-08-12,partly-cloudy-day,nan
2270,988,1282,2019-08-18,partly-cloudy-day,nan
0,0,0,2019-09-08,partly-cloudy-night,nan
1,0,1,2019-12-30,cloudy,New Year's Eve
1443,666,777,2019-09-11,clear-day,nan
728,411,317,2019-07-03,partly-cloudy-day,nan
541,286,255,2019-08-31,partly-cloudy-day,nan
0,0,0,2019-12-26,clear-night,nan
967,288,679,2019-07-04,clear-day,Independence Day
2644,1530,1114,2019-12-25,clear-day,Christmas Day
1769,794,975,2019-08-21,partly-cloudy-day,nan
94,62,32,2019-09-14,cloudy,nan
1751,954,797,2019-07-29,partly-cloudy-day,nan
0,0,0,2019-03-20,clear-night,nan
129,63,66,2019-03-03,partly-cloudy-day,nan
2197,1225,972,2019-08-05,partly-cloudy-day,nan
1301,641,660,2019-11-20,partly-cloudy-day,nan
0,0,0,2019-06-06,partly-cloudy-night,nan
187,89,98,2019-12-08,clear-night,nan
297,167,130,2019-01-21,partly-cloudy-day,Martin Luther King Jr. Day
405,220,185,2019-03-26,clear-day,nan
0,0,0,2019-04-28,partly-cloudy-night,nan
47,44,3,2019-02-15,clear-night,nan
3213,1450,1763,2019-08-24,partly-cloudy-day,nan
3105,1608,1497,2019-04-20,cloudy,nan
72,44,28,2019-07-09,clear-night,nan
88,50,38,2019-01-27,partly-cloudy-night,nan
186,98,88,2019-04-25,clear-night,nan
2600,1454,1146,2019-12-26,partly-cloudy-day,nan
88,86,2,2019-11-17,cloudy,nan
1278,608,670,2019-09-04,partly-cloudy-day,nan
661,336,325,2019-02-01,partly-cloudy-day,nan
20,19,1,2019-02-25,clear-night,nan
0,0,0,2019-07-04,clear-night,Independence Day
2,0,2,2019-10-31,rain,Halloween
72,42,30,2019-07-05,cloudy,nan
3414,1572,1842,2019-04-19,partly-cloudy-day,nan
2252,1015,1237,2019-04-19,partly-cloudy-day,nan
0,0,0,2019-05-07,partly-cloudy-night,nan
248,139,109,2019-01-15,clear-day,nan
775,419,356,2019-07-23,cloudy,nan
3258,1567,1691,2019-05-11,clear-day,nan
128,118,10,2019-02-05,partly-cloudy-night,nan
125,50,75,2019-01-16,partly-cloudy-night,nan
296,120,176,2019-05-08,partly-cloudy-day,nan
92,90,2,2019-06-20,partly-cloudy-night,nan
5,2,3,2019-03-06,clear-night,nan
0,0,0,2019-06-17,nan,nan
6,4,2,2019-01-24,cloudy,nan
1473,886,587,2019-04-07,clear-day,nan
2081,969,1112,2019-10-24,clear-day,nan
3023,1264,1759,2019-03-30,partly-cloudy-day,nan
124,51,73,2019-01-23,partly-cloudy-night,nan
1909,988,921,2019-04-08,partly-cloudy-day,nan
747,392,355,2019-10-24,clear-day,nan
1725,976,749,2019-08-27,partly-cloudy-day,nan
759,307,452,2019-06-02,partly-cloudy-day,nan
16,14,2,2019-12-06,partly-cloudy-night,nan
126,70,56,2019-04-20,rain,nan
793,391,402,2019-07-21,partly-cloudy-day,nan
2187,913,1274,2019-09-03,partly-cloudy-day,nan
1,0,1,2019-02-04,clear-night,nan
706,395,311,2019-07-31,rain,nan
55,28,27,2019-01-05,cloudy,nan
480,195,285,2019-07-10,clear-day,nan
3,1,2,2019-10-31,cloudy,nan
58,21,37,2019-07-05,cloudy,nan
2394,1030,1364,2019-07-24,partly-cloudy-day,nan
2673,1248,1425,2019-09-07,cloudy,nan
337,195,142,2019-01-26,clear-day,nan
38,0,38,2019-03-29,partly-cloudy-night,nan
0,0,0,2019-05-09,partly-cloudy-night,nan
1320,552,768,2019-12-04,partly-cloudy-day,nan
1358,882,476,2019-10-13,partly-cloudy-day,nan
4,0,4,2019-12-27,clear-night,nan
2466,1011,1455,2019-08-04,partly-cloudy-day,nan
578,279,299,2019-01-14,clear-day,nan
335,148,187,2019-06-19,cloudy,nan
16,14,2,2019-03-09,clear-night,nan
0,0,0,2019-03-25,cloudy,nan
0,0,0,2019-11-12,partly-cloudy-night,nan
32,31,1,2019-12-21,clear-night,nan
1973,845,1128,2019-10-07,partly-cloudy-day,nan
1360,726,634,2019-07-20,partly-cloudy-day,nan
0,0,0,2019-10-19,clear-night,nan
35,24,11,2019-04-26,rain,nan
761,344,417,2019-04-05,cloudy,nan
385,159,226,2019-10-11,clear-day,nan
1,0,1,2019-07-17,partly-cloudy-night,nan
850,367,483,2019-06-17,partly-cloudy-day,nan
206,107,99,2019-08-11,clear-day,nan
180,88,92,2019-09-02,partly-cloudy-day,Labor Day
0,0,0,2019-04-05,partly-cloudy-night,nan
2308,1142,1166,2019-08-15,partly-cloudy-day,nan
0,0,0,2019-03-17,clear-night,St. Patrick's Day
0,0,0,2019-03-14,cloudy,nan
402,187,215,2019-06-08,partly-cloudy-day,nan
1725,798,927,2019-06-27,partly-cloudy-day,nan
80,76,4,2019-01-25,clear-night,nan
1,0,1,2019-11-22,clear-night,nan
3,2,1,2019-11-01,clear-night,nan
0,0,0,2019-10-08,cloudy,nan
19,11,8,2019-01-06,partly-cloudy-night,nan
2740,1198,1542,2019-10-18,partly-cloudy-day,nan
2454,1167,1287,2019-09-22,partly-cloudy-day,nan
94,58,36,2019-02-03,clear-night,nan
1,0,1,2019-11-17,partly-cloudy-night,nan
70,42,28,2019-05-29,rain,nan
744,360,384,2019-06-13,cloudy,nan
466,175,291,2019-03-21,rain,nan
2,0,2,2019-07-24,cloudy,nan
13,8,5,2019-01-09,partly-cloudy-night,nan
38,38,0,2019-11-25,clear-night,nan
720,379,341,2019-02-18,cloudy,Presidents' Day (regional holiday)
8,7,1,2019-01-31,clear-night,nan
2592,1228,1364,2019-07-27,partly-cloudy-day,nan
2537,1093,1444,2019-07-05,partly-cloudy-day,nan
287,128,159,2019-08-22,partly-cloudy-day,nan
195,105,90,2019-08-09,clear-night,nan
3453,1762,1691,2019-12-31,cloudy,New Year's Eve
38,36,2,2019-04-12,rain,nan
46,25,21,2019-06-28,partly-cloudy-night,nan
0,0,0,2019-10-21,rain,nan
70,67,3,2019-01-26,partly-cloudy-night,nan
32,18,14,2019-04-25,cloudy,nan
76,50,26,2019-01-04,clear-night,nan
175,82,93,2019-11-16,clear-day,nan
39,30,9,2019-05-12,cloudy,nan
0,0,0,2019-12-15,partly-cloudy-night,nan
1695,740,955,2019-03-19,partly-cloudy-day,nan
148,62,86,2019-06-25,rain,nan
72,43,29,2019-06-24,clear-night,nan
1870,844,1026,2019-11-11,clear-day,Veterans Day
29,26,3,2019-10-04,clear-night,nan
0,0,0,2019-01-21,partly-cloudy-night,Martin Luther King Jr. Day
218,78,140,2019-11-27,clear-night,nan
138,60,78,2019-09-25,clear-night,nan
352,119,233,2019-02-05,partly-cloudy-day,nan
547,321,226,2019-11-29,clear-day,Black Friday
1934,847,1087,2019-06-30,partly-cloudy-day,nan
8,4,4,2019-05-14,cloudy,nan
0,0,0,2019-01-30,clear-night,nan
1027,466,561,2019-01-22,clear-day,nan
134,111,23,2019-01-03,partly-cloudy-night,nan
273,161,112,2019-12-22,clear-day,nan
1346,790,556,2019-05-07,partly-cloudy-day,nan
2,0,2,2019-01-11,partly-cloudy-night,nan
2834,1192,1642,2019-06-15,partly-cloudy-day,nan
664,297,367,2019-01-11,clear-day,nan
989,449,540,2019-10-23,clear-night,nan
0,0,0,2019-10-09,cloudy,nan
993,564,429,2019-04-11,cloudy,nan
945,491,454,2019-05-02,partly-cloudy-day,nan
1709,853,856,2019-08-13,partly-cloudy-day,nan
1763,782,981,2019-03-18,partly-cloudy-day,nan
0,0,0,2019-02-25,partly-cloudy-night,nan
2681,1264,1417,2019-05-31,partly-cloudy-day,nan
0,0,0,2019-04-27,cloudy,nan
0,0,0,2019-11-21,clear-night,nan
6,5,1,2019-11-15,clear-night,nan
1,0,1,2019-04-19,clear-night,nan
11,0,11,2019-02-12,rain,nan
35,26,9,2019-10-06,cloudy,nan
3,2,1,2019-07-22,partly-cloudy-night,nan
125,53,72,2019-02-07,cloudy,nan
166,74,92,2019-05-06,clear-day,nan
1915,939,976,2019-05-24,clear-day,nan
3257,1502,1755,2019-08-24,partly-cloudy-day,nan
14,9,5,2019-02-17,cloudy,nan
0,0,0,2019-02-10,clear-night,nan
323,171,152,2019-09-21,partly-cloudy-day,nan
3363,1544,1819,2019-08-10,partly-cloudy-day,nan
440,160,280,2019-09-11,partly-cloudy-day,nan
2259,1057,1202,2019-10-25,partly-cloudy-day,nan
1927,1127,800,2019-05-18,clear-day,nan
2070,898,1172,2019-07-13,clear-day,nan
39,0,39,2019-12-15,clear-night,nan
1483,795,688,2019-04-30,partly-cloudy-day,nan
19,16,3,2019-09-25,clear-night,nan
580,269,311,2019-11-12,cloudy,nan
8,4,4,2019-06-29,clear-night,nan
0,0,0,2019-01-27,partly-cloudy-night,nan
2,1,1,2019-02-08,rain,nan
2128,1156,972,2019-08-16,partly-cloudy-day,nan
11,10,1,2019-10-12,partly-cloudy-night,nan
349,161,188,2019-12-01,sleet,nan
2,0,2,2019-11-24,clear-night,nan
92,91,1,2019-11-16,clear-night,nan
3,2,1,2019-09-03,clear-night,nan
0,0,0,2019-05-26,cloudy,nan
2290,1232,1058,2019-06-15,partly-cloudy-day,nan
221,89,132,2019-05-30,cloudy,nan
267,68,199,2019-10-27,rain,nan
1,0,1,2019-02-26,clear-night,nan
16,10,6,2019-03-06,clear-night,nan
0,0,0,2019-02-02,clear-night,nan
44,30,14,2019-04-16,cloudy,nan
24,12,12,2019-03-02,cloudy,nan
12,10,2,2019-12-20,partly-cloudy-night,nan
989,572,417,2019-04-06,cloudy,nan
902,359,543,2019-08-04,partly-cloudy-day,nan
89,66,23,2019-09-09,partly-cloudy-night,nan
174,97,77,2019-04-21,cloudy,Easter Sunday
283,132,151,2019-10-13,clear-night,nan
118,41,77,2019-02-09,clear-night,nan
233,116,117,2019-02-12,fog,nan
1218,711,507,2019-10-11,cloudy,nan
33,19,14,2019-07-16,partly-cloudy-night,nan
48,45,3,2019-04-04,clear-night,nan
2,1,1,2019-04-22,clear-night,Easter Monday
34,23,11,2019-06-10,cloudy,nan
0,0,0,2019-10-30,cloudy,nan
467,215,252,2019-11-07,cloudy,nan
11,7,4,2019-02-23,cloudy,nan
7,4,3,2019-07-28,clear-night,nan
16,0,16,2019-04-05,rain,nan
1672,685,987,2019-09-26,partly-cloudy-day,nan
756,390,366,2019-04-17,cloudy,nan
2086,898,1188,2019-07-28,partly-cloudy-day,nan
6,5,1,2019-01-28,clear-night,nan
798,295,503,2019-10-20,rain,nan
808,427,381,2019-01-07,partly-cloudy-day,nan
28,26,2,2019-05-03,cloudy,nan
2710,1433,1277,2019-12-27,cloudy,nan
0,0,0,2019-10-01,cloudy,nan
1806,785,1021,2019-10-01,clear-day,nan
1084,439,645,2019-10-22,cloudy,nan
25,14,11,2019-01-09,partly-cloudy-night,nan
9,9,0,2019-02-19,clear-night,nan
704,299,405,2019-02-27,partly-cloudy-day,nan
37,32,5,2019-10-06,cloudy,nan
3043,1458,1585,2019-04-13,partly-cloudy-day,nan
93,70,23,2019-05-04,cloudy,Cinco de Mayo
1280,563,717,2019-12-03,clear-day,nan
503,272,231,2019-01-05,rain,nan
6,0,6,2019-11-01,rain,nan
135,128,7,2019-01-14,clear-night,nan
1157,664,493,2019-08-14,cloudy,nan
1982,1003,979,2019-08-16,partly-cloudy-day,nan
7,0,7,2019-12-12,clear-night,nan
16,4,12,2019-05-12,rain,Mother's Day
0,0,0,2019-04-08,cloudy,nan
1406,725,681,2019-12-14,cloudy,nan
0,0,0,2019-07-15,clear-night,nan
1734,955,779,2019-04-29,clear-day,nan
7,5,2,2019-01-20,rain,nan
34,30,4,2019-02-08,clear-night,nan
87,80,7,2019-10-17,cloudy,nan
167,98,69,2019-09-01,partly-cloudy-night,nan
0,0,0,2019-02-14,partly-cloudy-night,Valentine's Day
177,96,81,2019-03-23,partly-cloudy-day,nan
191,94,97,2019-12-17,rain,nan
63,40,23,2019-06-12,clear-night,nan
131,78,53,2019-08-29,clear-night,nan
62,45,17,2019-04-23,partly-cloudy-night,nan
0,0,0,2019-11-12,clear-night,nan
207,84,123,2019-05-02,cloudy,nan
1606,931,675,2019-07-09,clear-day,nan
2658,1240,1418,2019-10-05,clear-day,nan
32,0,32,2019-03-17,clear-night,St. Patrick's Day
73,48,25,2019-07-27,clear-night,nan
2355,1068,1287,2019-12-08,partly-cloudy-day,nan
1566,744,822,2019-09-23,partly-cloudy-day,nan
267,128,139,2019-02-16,clear-day,nan
2629,1354,1275,2019-09-07,clear-day,nan
0,0,0,2019-11-26,clear-night,nan
1315,776,539,2019-04-18,cloudy,nan
259,84,175,2019-03-12,partly-cloudy-day,nan
2,1,1,2019-02-08,cloudy,nan
12,0,12,2019-12-17,cloudy,nan
29,0,29,2019-12-11,clear-night,nan
570,260,310,2019-01-29,cloudy,nan
2709,1319,1390,2019-11-30,clear-day,nan
542,245,297,2019-01-22,partly-cloudy-night,nan
9,4,5,2019-05-26,cloudy,nan
1391,232,1159,2019-02-18,partly-cloudy-night,Presidents' Day (regional holiday)
533,251,282,2019-05-28,cloudy,nan
999,537,462,2019-04-26,cloudy,nan
3,1,2,2019-02-10,cloudy,nan
1296,675,621,2019-03-28,clear-day,nan
1143,521,622,2019-04-11,cloudy,nan
584,286,298,2019-12-02,cloudy,nan
1864,865,999,2019-07-25,partly-cloudy-day,nan
1840,821,1019,2019-09-18,partly-cloudy-day,nan
1265,510,755,2019-07-21,partly-cloudy-day,nan
491,305,186,2019-07-21,partly-cloudy-day,nan
784,308,476,2019-10-02,clear-day,nan
2610,1247,1363,2019-08-11,partly-cloudy-day,nan
59,59,0,2019-02-19,clear-night,nan
866,398,468,2019-11-13,clear-day,nan
896,556,340,2019-09-22,clear-day,nan
1804,911,893,2019-07-30,partly-cloudy-day,nan
1655,803,852,2019-07-16,partly-cloudy-day,nan
923,520,403,2019-01-06,cloudy,nan
1433,646,787,2019-12-18,partly-cloudy-day,nan
1462,730,732,2019-03-18,cloudy,nan
0,0,0,2019-02-28,cloudy,nan
74,73,1,2019-11-13,clear-night,nan
9,2,7,2019-10-01,clear-night,nan
2402,1063,1339,2019-04-12,partly-cloudy-day,nan
10,9,1,2019-03-22,rain,nan
921,416,505,2019-01-17,partly-cloudy-day,nan
169,92,77,2019-08-28,cloudy,nan
1595,852,743,2019-05-04,cloudy,nan
29,26,3,2019-08-07,rain,nan
2229,1073,1156,2019-08-29,partly-cloudy-day,nan
78,58,20,2019-10-11,cloudy,nan
1105,456,649,2019-04-09,cloudy,nan
1378,801,577,2019-03-03,partly-cloudy-day,nan
514,195,319,2019-06-26,partly-cloudy-day,nan
9,8,1,2019-10-20,rain,nan
4,0,4,2019-04-08,clear-night,nan
1,0,1,2019-09-05,clear-night,nan
48,0,48,2019-12-05,rain,nan
2609,1119,1490,2019-04-24,clear-day,nan
0,0,0,2019-04-11,clear-night,nan
879,523,356,2019-03-08,clear-day,nan
292,151,141,2019-03-12,clear-night,nan
1777,968,809,2019-09-23,partly-cloudy-day,nan
2168,1202,966,2019-08-15,partly-cloudy-day,nan
1,0,1,2019-04-03,partly-cloudy-night,nan
112,58,54,2019-12-19,clear-night,nan
0,0,0,2019-06-01,clear-night,nan
2641,1122,1519,2019-10-06,cloudy,nan
12,11,1,2019-02-09,clear-night,nan
764,371,393,2019-08-12,clear-night,nan
1235,646,589,2019-04-01,clear-day,nan
884,480,404,2019-09-26,rain,nan
10,9,1,2019-12-24,clear-night,Christmas Day
483,231,252,2019-02-20,snow,nan
379,132,247,2019-08-06,partly-cloudy-day,nan
150,72,78,2019-10-03,rain,nan
0,0,0,2019-02-02,nan,nan
1875,851,1024,2019-06-06,partly-cloudy-day,nan
38,23,15,2019-06-09,clear-night,nan
965,454,511,2019-02-04,clear-day,nan
1444,607,837,2019-11-08,clear-day,nan
0,0,0,2019-04-29,clear-night,nan
0,0,0,2019-08-13,partly-cloudy-night,nan
45,36,9,2019-10-15,clear-night,nan
2168,977,1191,2019-08-05,clear-day,nan
1078,614,464,2019-03-27,clear-day,nan
0,0,0,2019-12-24,clear-night,Christmas Eve
189,91,98,2019-08-01,partly-cloudy-day,nan
5,3,2,2019-04-26,rain,nan
1987,876,1111,2019-11-04,clear-day,nan
1743,751,992,2019-05-23,partly-cloudy-day,nan
1641,723,918,2019-01-27,partly-cloudy-day,nan
1078,438,640,2019-02-13,rain,nan
176,106,70,2019-04-17,cloudy,nan
6,5,1,2019-01-29,cloudy,nan
39,38,1,2019-02-21,clear-night,nan
714,440,274,2019-04-14,partly-cloudy-day,nan
1185,680,505,2019-08-06,partly-cloudy-day,nan
717,425,292,2019-02-14,partly-cloudy-day,Valentine's Day
27,26,1,2019-10-16,rain,nan
0,0,0,2019-01-12,partly-cloudy-day,nan
1105,569,536,2019-09-24,partly-cloudy-day,nan
1604,694,910,2019-10-19,clear-day,nan
2,0,2,2019-12-30,rain,nan
0,0,0,2019-12-13,clear-night,nan
1,0,1,2019-03-02,snow,nan
1108,498,610,2019-03-05,clear-day,nan
0,0,0,2019-04-20,rain,nan
366,145,221,2019-11-27,clear-day,nan
1,1,0,2019-08-24,clear-night,nan
0,0,0,2019-02-06,clear-night,nan
0,0,0,2019-10-04,cloudy,nan
1685,883,802,2019-05-10,rain,nan
25,0,25,2019-03-28,partly-cloudy-night,nan
1876,1113,763,2019-08-17,cloudy,nan
0,0,0,2019-02-02,clear-day,nan
291,114,177,2019-09-14,cloudy,nan
1310,676,634,2019-10-08,partly-cloudy-day,nan
2592,1118,1474,2019-07-07,partly-cloudy-day,nan
14,0,14,2019-12-03,clear-night,nan
180,91,89,2019-08-24,partly-cloudy-night,nan
94,59,35,2019-07-02,clear-night,nan
256,134,122,2019-03-10,rain,Daylight Saving Time starts
0,0,0,2019-09-20,clear-night,nan
2654,1084,1570,2019-11-02,clear-day,nan
136,68,68,2019-09-19,clear-night,nan
34,16,18,2019-06-13,partly-cloudy-night,nan
290,166,124,2019-08-18,partly-cloudy-night,nan
0,0,0,2019-11-08,clear-night,nan
303,147,156,2019-09-17,clear-day,nan
2126,920,1206,2019-10-10,partly-cloudy-day,nan
0,0,0,2019-03-31,clear-night,nan
9,4,5,2019-01-19,sleet,nan
2124,997,1127,2019-06-03,clear-day,nan
1303,540,763,2019-08-07,rain,nan
64,62,2,2019-02-06,cloudy,nan
3102,1321,1781,2019-06-08,clear-day,nan
14,4,10,2019-06-20,fog,nan
190,93,97,2019-05-12,rain,Mother's Day
0,0,0,2019-03-28,clear-night,nan
593,343,250,2019-04-09,cloudy,nan
1726,746,980,2019-11-15,clear-day,nan
1898,1024,874,2019-07-01,partly-cloudy-day,nan
0,0,0,2019-11-22,cloudy,nan
130,52,78,2019-02-12,cloudy,nan
2022,1115,907,2019-11-28,partly-cloudy-day,Thanksgiving Day
0,0,0,2019-06-03,partly-cloudy-night,nan
16,16,0,2019-02-19,clear-night,nan
37,0,37,2019-09-29,partly-cloudy-night,nan
1978,795,1183,2019-11-26,clear-day,nan
105,43,62,2019-01-10,cloudy,nan
191,88,103,2019-01-26,clear-day,nan
2,0,2,2019-07-21,clear-night,nan
56,0,56,2019-10-12,cloudy,nan
1,0,1,2019-05-03,cloudy,nan
0,0,0,2019-07-30,clear-night,nan
445,242,203,2019-01-17,partly-cloudy-day,nan
228,99,129,2019-08-21,partly-cloudy-day,nan
1,0,1,2019-02-11,cloudy,nan
48,37,11,2019-01-13,partly-cloudy-night,nan
298,141,157,2019-04-06,cloudy,nan
378,170,208,2019-10-07,cloudy,nan
2221,1152,1069,2019-06-14,partly-cloudy-day,nan
2504,1085,1419,2019-01-06,partly-cloudy-day,nan
5,0,5,2019-05-16,cloudy,nan
10,0,10,2019-09-07,cloudy,nan
592,367,225,2019-02-16,clear-day,nan
2452,1112,1340,2019-12-07,clear-day,nan
0,0,0,2019-11-02,clear-night,nan
62,60,2,2019-12-22,clear-night,nan
3462,1643,1819,2019-04-27,partly-cloudy-day,nan
2687,1179,1508,2019-05-06,partly-cloudy-day,nan
40,30,10,2019-01-24,rain,nan
2,0,2,2019-03-15,rain,nan
4,3,1,2019-04-19,clear-night,nan
1697,792,905,2019-04-04,clear-day,nan
1054,507,547,2019-02-11,cloudy,nan
2078,717,1361,2019-04-25,partly-cloudy-day,nan
25,18,7,2019-03-01,cloudy,nan
37,19,18,2019-07-24,partly-cloudy-night,nan
2966,1406,1560,2019-04-20,partly-cloudy-day,nan
65,42,23,2019-03-26,clear-night,nan
0,0,0,2019-05-21,clear-night,nan
42,26,16,2019-05-18,clear-night,nan
745,386,359,2019-01-13,partly-cloudy-day,nan
416,173,243,2019-11-06,clear-night,nan
3302,1630,1672,2019-09-01,partly-cloudy-day,nan
1995,818,1177,2019-03-03,partly-cloudy-day,nan
1,0,1,2019-11-24,rain,nan
1193,694,499,2019-06-04,clear-day,nan
0,0,0,2019-10-28,clear-night,nan
2803,1185,1618,2019-05-19,clear-day,nan
0,0,0,2019-09-12,partly-cloudy-night,nan
1978,802,1176,2019-08-27,partly-cloudy-day,nan
60,48,12,2019-05-11,cloudy,Mother's Day
12,8,4,2019-07-15,clear-night,nan
3077,1323,1754,2019-04-16,clear-day,nan
937,365,572,2019-12-18,partly-cloudy-day,nan
1805,842,963,2019-03-29,cloudy,nan
401,240,161,2019-06-29,partly-cloudy-day,nan
3199,1928,1271,2019-12-28,partly-cloudy-day,nan
380,209,171,2019-01-10,partly-cloudy-day,nan
14,10,4,2019-01-01,cloudy,New Year's Day
1,0,1,2019-03-13,partly-cloudy-night,nan
13,12,1,2019-02-26,clear-night,nan
847,506,341,2019-08-31,partly-cloudy-day,nan
1272,678,594,2019-07-26,clear-day,nan
2,0,2,2019-11-11,clear-night,nan
3511,1645,1866,2019-05-04,partly-cloudy-day,nan
1787,770,1017,2019-04-10,clear-day,nan
0,0,0,2019-02-22,clear-night,nan
0,0,0,2019-11-03,clear-night,nan
2,1,1,2019-08-25,cloudy,nan
175,82,93,2019-03-04,cloudy,nan
1944,1036,908,2019-08-09,partly-cloudy-day,nan
1151,545,606,2019-06-24,partly-cloudy-day,nan
2601,1112,1489,2019-09-21,clear-day,nan
48,43,5,2019-11-02,partly-cloudy-night,nan
39,38,1,2019-04-06,clear-night,nan
2530,1191,1339,2019-09-15,partly-cloudy-day,nan
0,0,0,2019-09-20,clear-night,nan
3,1,2,2019-01-12,clear-night,nan
464,278,186,2019-05-27,clear-day,Memorial Day
870,470,400,2019-02-05,partly-cloudy-day,nan
0,0,0,2019-09-09,partly-cloudy-night,nan
470,220,250,2019-05-13,cloudy,nan
16,7,9,2019-02-15,partly-cloudy-night,nan
41,0,41,2019-11-14,clear-night,nan
0,0,0,2019-08-14,partly-cloudy-night,nan
911,523,388,2019-07-07,cloudy,nan
795,333,462,2019-10-03,cloudy,nan
1096,655,441,2019-06-28,clear-day,nan
1759,1002,757,2019-07-12,clear-day,nan
0,0,0,2019-01-22,clear-night,nan
992,493,499,2019-12-12,clear-day,nan
14,13,1,2019-05-05,rain,nan
7,5,2,2019-08-26,partly-cloudy-night,nan
1563,729,834,2019-05-20,partly-cloudy-day,nan
41,35,6,2019-03-31,partly-cloudy-night,nan
0,0,0,2019-08-01,clear-night,nan
6,4,2,2019-01-19,clear-night,nan
47,38,9,2019-08-17,partly-cloudy-night,nan
1592,822,770,2019-06-19,cloudy,nan
52,0,52,2019-11-26,clear-night,nan
0,0,0,2019-04-02,cloudy,nan
23,13,10,2019-08-10,partly-cloudy-night,nan
0,0,0,2019-01-18,partly-cloudy-night,nan
0,0,0,2019-08-03,partly-cloudy-night,nan
1295,712,583,2019-07-23,cloudy,nan
67,65,2,2019-11-09,clear-night,nan
0,0,0,2019-01-11,partly-cloudy-night,nan
1647,803,844,2019-11-03,clear-day,Daylight Saving Time ends
283,103,180,2019-01-04,clear-day,nan
0,0,0,2019-01-28,clear-night,nan
0,0,0,2019-09-09,partly-cloudy-night,nan
1003,434,569,2019-06-12,partly-cloudy-day,nan
358,133,225,2019-10-29,cloudy,nan
0,0,0,2019-09-28,partly-cloudy-night,nan
1879,846,1033,2019-06-11,partly-cloudy-day,nan
72,55,17,2019-09-16,cloudy,nan
1395,583,812,2019-03-12,partly-cloudy-day,nan
319,190,129,2019-02-08,cloudy,nan
3040,1499,1541,2019-12-23,clear-day,nan
11,3,8,2019-01-07,partly-cloudy-night,nan
0,0,0,2019-10-07,cloudy,nan
1855,789,1066,2019-11-25,clear-day,nan
32,24,8,2019-04-23,partly-cloudy-night,nan
7,6,1,2019-12-01,rain,nan
81,48,33,2019-07-26,clear-night,nan
113,91,22,2019-11-07,cloudy,nan
284,178,106,2019-06-25,rain,nan
121,37,84,2019-05-05,rain,Cinco de Mayo
0,0,0,2019-03-24,clear-night,nan
1881,817,1064,2019-10-08,partly-cloudy-day,nan
2290,1285,1005,2019-01-02,clear-day,nan
2594,1190,1404,2019-07-06,partly-cloudy-day,nan
157,74,83,2019-12-19,clear-day,nan
2243,1081,1162,2019-10-10,partly-cloudy-day,nan
152,56,96,2019-06-23,clear-day,nan
0,0,0,2019-03-17,clear-night,St. Patrick's Day
0,0,0,2019-03-28,clear-night,nan
1084,590,494,2019-10-08,partly-cloudy-day,nan
1390,724,666,2019-04-30,cloudy,nan
50,40,10,2019-09-27,clear-night,nan
554,313,241,2019-01-28,clear-day,nan
1313,547,766,2019-04-15,partly-cloudy-day,Tax Day
1911,1094,817,2019-05-26,clear-day,nan
0,0,0,2019-08-23,rain,nan
847,476,371,2019-07-06,partly-cloudy-day,nan
830,311,519,2019-05-21,clear-day,nan
1,0,1,2019-03-07,clear-night,nan
2,1,1,2019-12-29,partly-cloudy-night,nan
68,65,3,2019-10-26,partly-cloudy-night,nan
0,0,0,2019-06-20,rain,nan
1,0,1,2019-10-26,partly-cloudy-night,nan
2590,1375,1215,2019-10-21,partly-cloudy-day,nan
1260,577,683,2019-03-25,cloudy,nan
9,0,9,2019-12-30,rain,nan
6,4,2,2019-02-28,clear-night,nan
1400,678,722,2019-09-11,partly-cloudy-day,nan
0,0,0,2019-08-31,clear-night,nan
468,196,272,2019-01-20,partly-cloudy-night,nan
57,54,3,2019-02-14,clear-night,Valentine's Day
1936,1033,903,2019-06-11,clear-day,nan
56,32,24,2019-08-24,partly-cloudy-night,nan
38,35,3,2019-10-12,partly-cloudy-night,nan
0,0,0,2019-10-10,cloudy,nan
2015,926,1089,2019-08-15,partly-cloudy-day,nan
535,214,321,2019-03-09,clear-night,nan
2559,1107,1452,2019-08-16,cloudy,nan
1944,886,1058,2019-10-30,cloudy,nan
2296,1099,1197,2019-05-27,partly-cloudy-day,Memorial Day
8,7,1,2019-12-07,clear-night,nan
1724,871,853,2019-06-30,partly-cloudy-day,nan
1219,591,628,2019-05-06,clear-day,nan
1972,807,1165,2019-10-13,partly-cloudy-day,nan
1334,601,733,2019-03-27,clear-day,nan
0,0,0,2019-08-20,clear-night,nan
0,0,0,2019-01-31,clear-night,nan
1275,784,491,2019-07-04,partly-cloudy-day,Independence Day
36,17,19,2019-06-25,rain,nan
0,0,0,2019-03-23,cloudy,nan
2362,1056,1306,2019-05-24,partly-cloudy-day,nan
1416,680,736,2019-07-17,partly-cloudy-day,nan
0,0,0,2019-02-13,rain,nan
1,0,1,2019-08-26,partly-cloudy-night,nan
263,108,155,2019-09-06,partly-cloudy-day,nan
215,94,121,2019-04-04,clear-day,nan
275,130,145,2019-01-21,partly-cloudy-day,Martin Luther King Jr. Day
0,0,0,2019-01-29,clear-night,nan
1989,842,1147,2019-07-03,cloudy,nan
1947,915,1032,2019-07-24,partly-cloudy-day,nan
1909,1022,887,2019-08-19,partly-cloudy-day,nan
0,0,0,2019-10-15,clear-night,nan
1174,638,536,2019-08-21,rain,nan
1659,925,734,2019-05-02,partly-cloudy-day,nan
299,124,175,2019-05-07,cloudy,nan
304,172,132,2019-04-28,cloudy,nan
1,0,1,2019-03-07,clear-night,nan
482,267,215,2019-09-21,partly-cloudy-day,nan
1134,649,485,2019-07-15,clear-day,nan
453,270,183,2019-03-17,partly-cloudy-day,St. Patrick's Day
1,0,1,2019-08-15,partly-cloudy-night,nan
16,14,2,2019-05-04,cloudy,nan
200,91,109,2019-03-11,clear-night,nan
1,0,1,2019-07-03,partly-cloudy-night,nan
1247,573,674,2019-11-21,clear-day,nan
1,0,1,2019-07-05,partly-cloudy-night,nan
496,271,225,2019-06-22,clear-day,nan
30,27,3,2019-04-19,rain,nan
266,97,169,2019-03-29,cloudy,nan
28,13,15,2019-02-24,rain,nan
0,0,0,2019-03-20,clear-night,nan
1265,734,531,2019-09-03,clear-day,nan
1,0,1,2019-11-09,clear-night,nan
0,0,0,2019-05-14,cloudy,nan
2323,1126,1197,2019-10-18,partly-cloudy-day,nan
835,461,374,2019-05-23,partly-cloudy-day,nan
42,30,12,2019-06-17,partly-cloudy-night,nan
0,0,0,2019-01-18,cloudy,nan
2667,1059,1608,2019-11-10,cloudy,nan
6,5,1,2019-06-14,rain,nan
1884,879,1005,2019-09-30,partly-cloudy-day,nan
8,6,2,2019-03-15,partly-cloudy-night,nan
44,30,14,2019-07-24,partly-cloudy-night,nan
2028,854,1174,2019-10-24,clear-day,nan
17,0,17,2019-11-25,clear-night,nan
1393,655,738,2019-02-18,partly-cloudy-day,Presidents' Day (regional holiday)
579,273,306,2019-03-29,cloudy,nan
182,108,74,2019-09-03,clear-night,nan
365,165,200,2019-08-19,partly-cloudy-day,nan
589,310,279,2019-09-25,clear-day,nan
3,3,0,2019-02-20,clear-night,nan
9,8,1,2019-10-06,cloudy,nan
184,76,108,2019-02-20,clear-day,nan
117,90,27,2019-11-12,partly-cloudy-night,nan
1303,586,717,2019-01-25,clear-day,nan
1985,884,1101,2019-09-30,partly-cloudy-day,nan
160,121,39,2019-01-07,cloudy,nan
2846,1344,1502,2019-07-05,partly-cloudy-day,nan
3,1,2,2019-05-30,cloudy,nan
4,0,4,2019-11-01,cloudy,nan
1,0,1,2019-09-03,partly-cloudy-night,nan
0,0,0,2019-01-23,clear-night,nan
1795,758,1037,2019-09-19,clear-day,nan
179,108,71,2019-02-09,clear-day,nan
1,0,1,2019-04-22,clear-night,Easter Monday
81,42,39,2019-07-22,rain,nan
656,327,329,2019-09-17,clear-day,nan
165,130,35,2019-11-15,clear-night,nan
253,129,124,2019-11-12,rain,nan
1,0,1,2019-03-03,partly-cloudy-night,nan
1661,742,919,2019-07-23,cloudy,nan
974,559,415,2019-11-05,cloudy,nan
1349,594,755,2019-06-27,partly-cloudy-day,nan
101,30,71,2019-07-20,partly-cloudy-day,nan
2289,986,1303,2019-09-15,clear-day,nan
1431,638,793,2019-07-10,partly-cloudy-day,nan
46,39,7,2019-11-29,clear-night,Black Friday
492,180,312,2019-05-05,rain,Cinco de Mayo
605,292,313,2019-07-29,clear-day,nan
0,0,0,2019-02-03,clear-night,nan
76,75,1,2019-11-17,clear-night,nan
3046,1280,1766,2019-04-07,clear-day,nan
0,0,0,2019-11-04,clear-night,nan
1385,700,685,2019-05-22,clear-day,nan
12,0,12,2019-04-27,cloudy,nan
658,295,363,2019-04-05,cloudy,nan
161,54,107,2019-01-29,cloudy,nan
2944,1413,1531,2019-07-05,partly-cloudy-day,nan
1373,546,827,2019-05-14,cloudy,nan
787,343,444,2019-01-28,clear-day,nan
3383,1611,1772,2019-04-21,cloudy,Easter Sunday
60,36,24,2019-05-18,clear-night,nan
65,59,6,2019-04-13,clear-night,nan
1,0,1,2019-08-30,clear-night,nan
0,0,0,2019-11-01,rain,nan
1733,630,1103,2019-07-11,partly-cloudy-day,nan
12,10,2,2019-01-23,partly-cloudy-night,nan
222,103,119,2019-05-12,rain,Mother's Day
101,57,44,2019-11-07,partly-cloudy-night,nan
4,0,4,2019-06-03,cloudy,nan
250,118,132,2019-07-17,partly-cloudy-day,nan
127,62,65,2019-03-21,cloudy,nan
3,0,3,2019-12-06,clear-night,nan
0,0,0,2019-03-01,cloudy,nan
855,415,440,2019-12-04,cloudy,nan
1499,717,782,2019-02-08,clear-day,nan
32,20,12,2019-08-28,partly-cloudy-night,nan
2165,1151,1014,2019-07-08,partly-cloudy-day,nan
2442,1266,1176,2019-10-05,clear-day,nan
6,6,0,2019-03-26,clear-night,nan
752,378,374,2019-01-16,partly-cloudy-day,nan
0,0,0,2019-11-12,clear-night,nan
147,89,58,2019-06-15,partly-cloudy-night,Father's Day
1122,518,604,2019-01-11,clear-day,nan
1427,691,736,2019-09-11,clear-day,nan
1,0,1,2019-11-11,cloudy,Veterans Day
178,80,98,2019-10-09,partly-cloudy-night,nan
10,6,4,2019-04-30,partly-cloudy-night,nan
69,35,34,2019-04-15,rain,Tax Day
0,0,0,2019-03-12,clear-night,nan
0,0,0,2019-02-23,clear-night,nan
227,118,109,2019-06-18,rain,nan
2746,1381,1365,2019-03-30,clear-day,nan
1,0,1,2019-04-04,clear-night,nan
0,0,0,2019-12-05,partly-cloudy-night,nan
16,13,3,2019-09-15,clear-night,nan
2,1,1,2019-09-06,nan,nan
1,0,1,2019-10-18,cloudy,nan
46,37,9,2019-06-29,partly-cloudy-night,nan
44,26,18,2019-02-17,clear-night,nan
2,0,2,2019-01-28,partly-cloudy-night,nan
2,0,2,2019-05-12,rain,Mother's Day
2,0,2,2019-11-26,clear-night,nan
382,223,159,2019-01-09,partly-cloudy-night,nan
24,20,4,2019-10-25,clear-night,nan
50,26,24,2019-07-23,rain,nan
31,21,10,2019-01-21,partly-cloudy-night,Martin Luther King Jr. Day
249,105,144,2019-12-21,clear-day,nan
1253,593,660,2019-06-28,partly-cloudy-day,nan
11,10,1,2019-04-13,rain,nan
542,250,292,2019-01-05,rain,nan
5,3,2,2019-02-03,clear-night,nan
6,2,4,2019-03-04,cloudy,nan
2,1,1,2019-02-15,clear-night,nan
406,144,262,2019-09-10,cloudy,nan
0,0,0,2019-02-01,clear-night,nan
1,0,1,2019-11-29,clear-night,nan
2,1,1,2019-06-24,clear-night,nan
41,0,41,2019-12-13,rain,nan
103,103,0,2019-05-02,cloudy,nan
3373,1600,1773,2019-06-15,partly-cloudy-day,nan
2356,1219,1137,2019-04-20,cloudy,nan
281,145,136,2019-10-27,rain,nan
25,24,1,2019-03-24,partly-cloudy-night,nan
3,2,1,2019-05-08,nan,nan
807,334,473,2019-01-26,partly-cloudy-day,nan
2888,1258,1630,2019-08-25,partly-cloudy-day,nan
207,97,110,2019-07-10,partly-cloudy-day,nan
5,3,2,2019-12-03,cloudy,nan
790,338,452,2019-01-22,clear-day,nan
1654,798,856,2019-07-22,partly-cloudy-day,nan
91,56,35,2019-04-22,cloudy,nan
51,44,7,2019-08-04,clear-night,nan
671,391,280,2019-04-02,cloudy,nan
2671,1231,1440,2019-09-29,partly-cloudy-day,nan
19,18,1,2019-11-16,clear-night,nan
52,0,52,2019-12-04,partly-cloudy-night,nan
0,0,0,2019-02-09,clear-night,nan
0,0,0,2019-09-11,partly-cloudy-night,nan
72,42,30,2019-06-13,rain,nan
6,0,6,2019-10-23,clear-night,nan
24,0,24,2019-02-25,clear-night,nan
3371,1338,2033,2019-10-13,partly-cloudy-day,nan
2930,1605,1325,2019-12-27,cloudy,nan
0,0,0,2019-11-06,clear-night,nan
38,0,38,2019-11-20,partly-cloudy-night,nan
34,17,17,2019-01-15,clear-night,nan
907,436,471,2019-10-24,clear-night,nan
3,0,3,2019-01-06,clear-night,nan
8,4,4,2019-05-24,clear-night,nan
1,0,1,2019-09-15,partly-cloudy-night,nan
309,191,118,2019-03-03,partly-cloudy-day,nan
10,10,0,2019-12-26,cloudy,nan
443,178,265,2019-07-15,clear-day,nan
0,0,0,2019-04-08,cloudy,nan
1756,748,1008,2019-02-17,clear-day,nan
1411,627,784,2019-09-04,partly-cloudy-day,nan
2404,1010,1394,2019-04-29,clear-day,nan
201,95,106,2019-02-12,fog,nan
1575,719,856,2019-10-01,cloudy,nan
2089,937,1152,2019-10-11,cloudy,nan
11,0,11,2019-04-05,clear-night,nan
223,134,89,2019-06-21,rain,nan
131,80,51,2019-04-17,partly-cloudy-night,nan
1704,773,931,2019-05-17,cloudy,nan
0,0,0,2019-10-20,clear-night,nan
11,9,2,2019-04-19,clear-night,nan
133,65,68,2019-07-10,partly-cloudy-night,nan
2695,1314,1381,2019-03-23,clear-day,nan
18,8,10,2019-08-26,clear-night,nan
115,90,25,2019-01-15,clear-night,nan
0,0,0,2019-10-13,clear-night,nan
2870,1292,1578,2019-08-24,clear-day,nan
344,179,165,2019-02-01,partly-cloudy-day,nan
818,482,336,2019-10-25,clear-day,nan
1704,912,792,2019-07-01,clear-day,nan
0,0,0,2019-08-29,partly-cloudy-night,nan
1277,546,731,2019-11-07,cloudy,nan
7,5,2,2019-08-30,clear-night,nan
752,308,444,2019-11-18,cloudy,nan
0,0,0,2019-01-24,cloudy,nan
747,578,169,2019-09-08,partly-cloudy-day,nan
413,164,249,2019-09-26,clear-day,nan
0,0,0,2019-10-12,cloudy,nan
0,0,0,2019-05-18,clear-night,nan
344,185,159,2019-09-12,cloudy,nan
1,0,1,2019-12-20,cloudy,nan
510,245,265,2019-05-01,cloudy,nan
0,0,0,2019-12-01,clear-night,nan
3064,1299,1765,2019-10-05,clear-day,nan
3208,1348,1860,2019-10-19,clear-day,nan
204,96,108,2019-08-12,clear-night,nan
743,448,295,2019-12-08,clear-day,nan
53,33,20,2019-08-02,partly-cloudy-night,nan
228,134,94,2019-02-10,clear-day,nan
1679,1019,660,2019-07-16,partly-cloudy-day,nan
6,4,2,2019-01-20,rain,nan
7,7,0,2019-02-19,clear-night,nan
49,16,33,2019-12-17,rain,nan
136,64,72,2019-02-04,clear-night,nan
109,59,50,2019-07-20,partly-cloudy-day,nan
4,2,2,2019-10-07,rain,nan
1890,950,940,2019-11-29,partly-cloudy-day,Black Friday
2579,1121,1458,2019-10-18,partly-cloudy-day,nan
2327,1075,1252,2019-06-30,partly-cloudy-day,nan
10,9,1,2019-02-04,clear-night,nan
862,450,412,2019-03-06,partly-cloudy-day,nan
1726,904,822,2019-07-28,clear-day,nan
2629,1246,1383,2019-07-27,partly-cloudy-day,nan
2509,1112,1397,2019-06-23,clear-day,nan
1,0,1,2019-10-01,cloudy,nan
2087,882,1205,2019-09-13,partly-cloudy-day,nan
3325,1434,1891,2019-09-07,partly-cloudy-day,nan
2221,1011,1210,2019-04-18,cloudy,nan
1187,525,662,2019-10-22,cloudy,nan
0,0,0,2019-01-09,cloudy,nan
42,29,13,2019-05-29,rain,nan
1,0,1,2019-01-07,clear-night,nan
2220,1098,1122,2019-10-04,partly-cloudy-day,nan
580,306,274,2019-06-10,cloudy,nan
934,459,475,2019-09-16,cloudy,nan
2128,984,1144,2019-10-14,partly-cloudy-day,Columbus Day (regional holiday)
531,242,289,2019-02-13,cloudy,nan
2238,1033,1205,2019-08-14,cloudy,nan
864,388,476,2019-11-24,cloudy,nan
2340,1154,1186,2019-09-08,partly-cloudy-day,nan
330,106,224,2019-06-18,rain,nan
5,1,4,2019-07-14,clear-night,nan
2351,1022,1329,2019-05-03,cloudy,nan
503,255,248,2019-10-31,cloudy,Halloween
24,10,14,2019-08-15,partly-cloudy-night,nan
1,0,1,2019-06-16,cloudy,Father's Day
1574,788,786,2019-04-15,cloudy,Tax Day
61,57,4,2019-04-17,cloudy,nan
7,1,6,2019-03-18,partly-cloudy-night,nan
26,16,10,2019-07-17,rain,nan
263,115,148,2019-06-27,clear-day,nan
49,22,27,2019-11-14,clear-night,nan
0,0,0,2019-09-23,clear-night,nan
0,0,0,2019-08-21,partly-cloudy-night,nan
176,94,82,2019-12-02,snow,nan
1000,465,535,2019-03-06,partly-cloudy-day,nan
0,0,0,2019-02-02,clear-day,nan
1046,451,595,2019-11-13,clear-day,nan
2,0,2,2019-10-02,clear-night,nan
0,0,0,2019-08-16,partly-cloudy-night,nan
276,132,144,2019-07-30,clear-day,nan
19,18,1,2019-03-14,partly-cloudy-night,nan
1,0,1,2019-12-25,clear-night,Christmas Day
11,7,4,2019-03-16,partly-cloudy-night,nan
2667,1097,1570,2019-04-06,clear-day,nan
9,3,6,2019-01-03,cloudy,nan
25,13,12,2019-09-10,clear-night,nan
25,10,15,2019-01-22,partly-cloudy-night,nan
159,101,58,2019-10-20,rain,nan
235,102,133,2019-08-23,rain,nan
25,10,15,2019-08-06,partly-cloudy-night,nan
269,120,149,2019-05-22,clear-day,nan
212,145,67,2019-01-30,cloudy,nan
1,0,1,2019-01-24,cloudy,nan
0,0,0,2019-08-27,partly-cloudy-night,nan
36,35,1,2019-12-24,clear-night,Christmas Day
83,75,8,2019-02-11,partly-cloudy-night,nan
1358,717,641,2019-06-05,partly-cloudy-day,nan
1465,744,721,2019-03-15,partly-cloudy-day,nan
1981,979,1002,2019-05-21,clear-day,nan
337,156,181,2019-10-23,clear-night,nan
3102,1371,1731,2019-08-31,partly-cloudy-day,nan
1,0,1,2019-12-24,clear-night,Christmas Eve
0,0,0,2019-01-25,partly-cloudy-night,nan
1613,866,747,2019-11-30,clear-day,nan
0,0,0,2019-10-23,partly-cloudy-night,nan
1011,515,496,2019-12-30,cloudy,nan
1604,785,819,2019-02-05,clear-day,nan
1,0,1,2019-04-24,partly-cloudy-night,nan
559,283,276,2019-09-18,partly-cloudy-day,nan
4,3,1,2019-09-13,cloudy,nan
2806,1225,1581,2019-06-01,partly-cloudy-day,nan
72,71,1,2019-01-29,rain,nan
0,0,0,2019-03-05,clear-night,nan
2644,1186,1458,2019-01-03,partly-cloudy-day,nan
0,0,0,2019-11-18,cloudy,nan
1124,512,612,2019-11-08,partly-cloudy-day,nan
3343,1465,1878,2019-10-26,partly-cloudy-day,nan
157,66,91,2019-04-30,cloudy,nan
1,0,1,2019-05-19,partly-cloudy-night,nan
1566,672,894,2019-03-08,clear-day,nan
7,2,5,2019-09-17,clear-night,nan
2,0,2,2019-11-15,clear-night,nan
522,263,259,2019-08-22,partly-cloudy-day,nan
1612,743,869,2019-01-27,partly-cloudy-day,nan
2246,949,1297,2019-03-23,clear-day,nan
5,3,2,2019-11-27,cloudy,Thanksgiving Day
2,0,2,2019-12-11,snow,nan
1,0,1,2019-06-18,cloudy,nan
2888,1398,1490,2019-10-06,cloudy,nan
2353,1046,1307,2019-09-27,clear-day,nan
44,40,4,2019-09-26,clear-night,nan
2104,1081,1023,2019-07-01,partly-cloudy-day,nan
21,0,21,2019-04-10,clear-night,nan
2391,973,1418,2019-08-09,partly-cloudy-day,nan
52,48,4,2019-09-04,clear-night,nan
89,43,46,2019-02-12,fog,nan
942,447,495,2019-08-18,cloudy,nan
0,0,0,2019-05-27,clear-night,Memorial Day
977,591,386,2019-08-22,partly-cloudy-day,nan
73,34,39,2019-01-13,cloudy,nan
431,208,223,2019-12-14,cloudy,nan
3,2,1,2019-10-22,partly-cloudy-night,nan
1461,663,798,2019-07-22,partly-cloudy-day,nan
2,1,1,2019-09-19,clear-night,nan
3,0,3,2019-06-13,partly-cloudy-night,nan
1647,695,952,2019-09-24,partly-cloudy-day,nan
0,0,0,2019-11-22,partly-cloudy-night,nan
79,48,31,2019-01-01,partly-cloudy-night,New Year's Day
26,13,13,2019-12-06,clear-night,nan
1375,600,775,2019-02-14,clear-day,Valentine's Day
592,314,278,2019-10-17,cloudy,nan
200,125,75,2019-08-07,cloudy,nan
0,0,0,2019-06-10,clear-night,nan
1,0,1,2019-07-07,partly-cloudy-night,nan
171,85,86,2019-12-13,partly-cloudy-night,nan
1963,985,978,2019-05-10,partly-cloudy-day,nan
229,89,140,2019-02-06,clear-day,nan
32,19,13,2019-04-21,partly-cloudy-night,Easter Monday
2228,959,1269,2019-08-02,partly-cloudy-day,nan
2799,1319,1480,2019-10-28,partly-cloudy-day,nan
0,0,0,2019-09-10,cloudy,nan
2002,1110,892,2019-07-25,partly-cloudy-day,nan
6,0,6,2019-10-16,rain,nan
220,103,117,2019-01-30,clear-day,nan
0,0,0,2019-01-12,partly-cloudy-night,nan
7,5,2,2019-05-05,cloudy,Cinco de Mayo
0,0,0,2019-03-09,cloudy,nan
2510,1426,1084,2019-12-22,clear-day,nan
2,0,2,2019-04-09,cloudy,nan
11,7,4,2019-08-01,partly-cloudy-night,nan
1335,510,825,2019-08-13,cloudy,nan
0,0,0,2019-02-18,cloudy,Presidents' Day (regional holiday)
848,475,373,2019-09-02,rain,Labor Day
23,19,4,2019-12-29,rain,nan
1,0,1,2019-02-21,rain,nan
15,5,10,2019-01-07,clear-night,nan
19,0,19,2019-03-27,clear-night,nan
38,37,1,2019-06-28,clear-night,nan
7,4,3,2019-10-14,clear-night,nan
1979,850,1129,2019-03-14,partly-cloudy-day,nan
1959,1071,888,2019-07-25,clear-day,nan
151,50,101,2019-08-17,cloudy,nan
221,81,140,2019-02-28,partly-cloudy-day,nan
13,6,7,2019-08-13,cloudy,nan
590,259,331,2019-01-30,clear-day,nan
15,3,12,2019-07-01,clear-night,nan
1004,574,430,2019-05-09,cloudy,nan
36,32,4,2019-10-03,rain,nan
99,71,28,2019-12-19,clear-night,nan
330,111,219,2019-04-02,clear-day,nan
2248,992,1256,2019-07-14,partly-cloudy-day,nan
16,15,1,2019-02-06,rain,nan
11,7,4,2019-05-14,cloudy,nan
16,7,9,2019-01-18,cloudy,nan
25,20,5,2019-10-02,cloudy,nan
1182,614,568,2019-02-10,clear-day,nan
31,14,17,2019-01-04,cloudy,nan
1319,641,678,2019-11-28,partly-cloudy-day,Thanksgiving Day
88,48,40,2019-12-09,rain,nan
49,23,26,2019-03-07,clear-night,nan
158,74,84,2019-03-31,partly-cloudy-day,nan
2172,873,1299,2019-10-15,clear-day,nan
17,6,11,2019-03-25,cloudy,nan
2046,1010,1036,2019-06-12,partly-cloudy-day,nan
2,0,2,2019-03-08,partly-cloudy-night,nan
791,333,458,2019-05-16,clear-day,nan
91,57,34,2019-04-18,partly-cloudy-night,nan
0,0,0,2019-12-25,clear-night,Christmas Day
873,447,426,2019-01-14,clear-day,nan
0,0,0,2019-08-18,cloudy,nan
29,27,2,2019-10-27,partly-cloudy-night,nan
1047,633,414,2019-06-06,partly-cloudy-day,nan
266,116,150,2019-07-26,clear-day,nan
2,1,1,2019-07-25,partly-cloudy-night,nan
308,133,175,2019-09-23,clear-day,nan
1361,530,831,2019-08-28,cloudy,nan
912,472,440,2019-03-10,cloudy,Daylight Saving Time starts
2441,1041,1400,2019-06-09,clear-day,nan
262,141,121,2019-10-26,clear-night,nan
2270,1214,1056,2019-08-04,partly-cloudy-day,nan
465,223,242,2019-10-16,cloudy,nan
2105,921,1184,2019-09-05,partly-cloudy-day,nan
21,9,12,2019-07-08,clear-night,nan
2082,1119,963,2019-06-02,partly-cloudy-day,nan
379,163,216,2019-04-24,clear-night,nan
3291,1782,1509,2019-12-29,cloudy,nan
0,0,0,2019-03-22,clear-night,nan
16,10,6,2019-02-09,clear-night,nan
0,0,0,2019-02-22,clear-night,nan
2692,1442,1250,2019-08-17,partly-cloudy-day,nan
2009,1055,954,2019-10-12,cloudy,nan
133,61,72,2019-05-25,clear-day,nan
7,4,3,2019-06-25,partly-cloudy-night,nan
1,1,0,2019-12-07,clear-night,nan
1105,660,445,2019-07-31,partly-cloudy-day,nan
4,0,4,2019-08-22,partly-cloudy-night,nan
155,94,61,2019-11-11,clear-night,Veterans Day
1018,635,383,2019-05-11,partly-cloudy-day,nan
2524,1139,1385,2019-06-14,cloudy,nan
1637,728,909,2019-12-05,partly-cloudy-day,nan
2,1,1,2019-01-31,clear-night,nan
0,0,0,2019-09-07,cloudy,nan
2541,982,1559,2019-10-21,clear-day,nan
0,0,0,2019-08-19,partly-cloudy-night,nan
947,355,592,2019-04-22,cloudy,Easter Monday
3,2,1,2019-04-15,partly-cloudy-night,nan
2,1,1,2019-02-27,cloudy,nan
47,23,24,2019-07-08,cloudy,nan
2240,1059,1181,2019-05-15,partly-cloudy-day,nan
822,507,315,2019-07-13,clear-day,nan
597,352,245,2019-08-27,partly-cloudy-day,nan
1604,768,836,2019-04-01,clear-day,nan
21,18,3,2019-11-07,rain,nan
1146,566,580,2019-06-28,partly-cloudy-day,nan
35,27,8,2019-07-06,partly-cloudy-night,nan
0,0,0,2019-03-16,partly-cloudy-night,nan
1559,722,837,2019-04-28,cloudy,nan
149,63,86,2019-12-04,cloudy,nan
852,386,466,2019-05-14,cloudy,nan
1,0,1,2019-07-18,partly-cloudy-night,nan
0,0,0,2019-03-15,clear-night,nan
208,86,122,2019-04-11,partly-cloudy-day,nan
1828,977,851,2019-06-07,partly-cloudy-day,nan
16,13,3,2019-02-22,clear-night,nan
60,49,11,2019-07-23,cloudy,nan
1839,927,912,2019-07-26,partly-cloudy-day,nan
1138,687,451,2019-05-08,partly-cloudy-day,nan
1175,652,523,2019-04-10,partly-cloudy-day,nan
0,0,0,2019-07-27,clear-night,nan
4,3,1,2019-11-28,clear-night,Black Friday
540,216,324,2019-04-24,clear-day,nan
252,109,143,2019-06-11,cloudy,nan
670,327,343,2019-07-02,clear-day,nan
33,31,2,2019-12-14,cloudy,nan
6,4,2,2019-09-28,clear-night,nan
880,485,395,2019-07-31,partly-cloudy-day,nan
48,44,4,2019-03-05,clear-night,nan
401,211,190,2019-11-14,partly-cloudy-day,nan
2,0,2,2019-06-30,partly-cloudy-night,nan
64,40,24,2019-07-12,clear-night,nan
1942,933,1009,2019-12-15,clear-day,nan
1495,583,912,2019-12-12,clear-day,nan
50,0,50,2019-11-09,clear-night,nan
25,0,25,2019-11-18,rain,nan
650,290,360,2019-05-31,clear-day,nan
5,3,2,2019-01-18,cloudy,nan
33,23,10,2019-02-21,cloudy,nan
1371,687,684,2019-04-29,partly-cloudy-day,nan
78,68,10,2019-10-02,cloudy,nan
5,0,5,2019-03-03,snow,nan
1,0,1,2019-04-01,clear-night,nan
0,0,0,2019-11-20,cloudy,nan
1015,626,389,2019-11-22,partly-cloudy-day,nan
0,0,0,2019-11-13,clear-night,nan
14,0,14,2019-01-11,clear-night,nan
530,232,298,2019-07-11,partly-cloudy-day,nan
0,0,0,2019-10-21,clear-night,nan
58,45,13,2019-02-15,cloudy,nan
4,1,3,2019-01-13,clear-night,nan
371,144,227,2019-05-01,cloudy,nan
0,0,0,2019-05-01,cloudy,nan
174,96,78,2019-08-30,clear-night,nan
1,0,1,2019-07-29,clear-night,nan
171,82,89,2019-11-23,clear-day,nan
6,0,6,2019-09-24,cloudy,nan
0,0,0,2019-10-29,cloudy,nan
1,0,1,2019-04-28,clear-night,nan
215,116,99,2019-12-31,cloudy,New Year's Eve
2,0,2,2019-09-14,partly-cloudy-night,nan
2,1,1,2019-12-01,cloudy,nan
354,191,163,2019-02-11,cloudy,nan
3,1,2,2019-04-23,cloudy,nan
3661,1605,2056,2019-04-21,partly-cloudy-day,Easter Sunday
162,72,90,2019-03-13,clear-night,nan
2313,1187,1126,2019-11-16,clear-day,nan
1182,592,590,2019-05-06,cloudy,nan
449,146,303,2019-05-09,partly-cloudy-day,nan
2228,1147,1081,2019-04-25,clear-day,nan
2,1,1,2019-01-03,cloudy,nan
29,24,5,2019-02-13,partly-cloudy-night,nan
224,112,112,2019-08-25,partly-cloudy-night,nan
1231,640,591,2019-03-04,partly-cloudy-day,nan
2,2,0,2019-09-06,partly-cloudy-night,nan
1880,903,977,2019-07-03,partly-cloudy-day,nan
3,1,2,2019-04-18,cloudy,nan
1,0,1,2019-09-24,clear-night,nan
156,62,94,2019-05-16,partly-cloudy-day,nan
42,0,42,2019-11-04,clear-night,nan
1,0,1,2019-07-04,clear-night,nan
9,9,0,2019-12-25,clear-night,nan
2741,1287,1454,2019-05-24,partly-cloudy-day,nan
619,360,259,2019-07-08,rain,nan
2336,1077,1259,2019-10-14,clear-day,Columbus Day (regional holiday)
1245,654,591,2019-06-29,rain,nan
178,88,90,2019-08-08,partly-cloudy-night,nan
9,8,1,2019-12-02,cloudy,nan
0,0,0,2019-08-07,partly-cloudy-night,nan
115,114,1,2019-12-16,cloudy,nan
310,132,178,2019-08-29,clear-day,nan
1877,891,986,2019-09-19,clear-day,nan
297,118,179,2019-08-15,partly-cloudy-day,nan
41,25,16,2019-01-03,partly-cloudy-night,nan
2236,997,1239,2019-06-01,partly-cloudy-day,nan
527,279,248,2019-10-09,cloudy,nan
0,0,0,2019-12-21,clear-night,nan
1,0,1,2019-07-10,clear-night,nan
5,0,5,2019-07-01,clear-night,nan
174,63,111,2019-07-03,partly-cloudy-day,nan
145,56,89,2019-01-09,partly-cloudy-night,nan
0,0,0,2019-01-29,clear-night,nan
16,15,1,2019-12-04,cloudy,nan
1083,516,567,2019-06-26,clear-day,nan
0,0,0,2019-03-29,partly-cloudy-night,nan
1630,786,844,2019-06-20,cloudy,nan
642,334,308,2019-07-24,partly-cloudy-day,nan
0,0,0,2019-09-18,clear-night,nan
2309,1130,1179,2019-03-16,clear-day,nan
698,288,410,2019-03-24,clear-day,nan
427,212,215,2019-08-14,partly-cloudy-night,nan
1322,603,719,2019-03-13,clear-day,nan
3,0,3,2019-06-14,partly-cloudy-night,nan
2,1,1,2019-10-18,partly-cloudy-night,nan
36,0,36,2019-11-15,clear-night,nan
1688,830,858,2019-10-30,cloudy,nan
1,0,1,2019-11-09,clear-night,nan
1846,797,1049,2019-09-09,partly-cloudy-day,nan
1511,861,650,2019-08-14,cloudy,nan
1963,1002,961,2019-08-16,partly-cloudy-day,nan
1998,1072,926,2019-04-03,clear-day,nan
31,12,19,2019-04-13,rain,nan
3127,1423,1704,2019-05-18,clear-day,nan
1453,722,731,2019-08-27,partly-cloudy-day,nan
1058,531,527,2019-03-01,cloudy,nan
1568,675,893,2019-11-06,clear-day,nan
1,0,1,2019-12-16,clear-night,nan
1842,797,1045,2019-06-24,partly-cloudy-day,nan
0,0,0,2019-04-01,clear-night,nan
1,0,1,2019-06-09,clear-night,nan
134,89,45,2019-06-11,clear-night,nan
2102,940,1162,2019-03-17,partly-cloudy-day,St. Patrick's Day
0,0,0,2019-02-24,rain,nan
1321,709,612,2019-03-02,cloudy,nan
1440,779,661,2019-06-03,clear-day,nan
1,0,1,2019-03-10,sleet,Daylight Saving Time starts
1588,836,752,2019-05-10,partly-cloudy-day,nan
5,0,5,2019-04-23,cloudy,nan
680,362,318,2019-05-17,clear-day,nan
38,17,21,2019-05-19,partly-cloudy-night,nan
40,36,4,2019-06-07,clear-night,nan
244,122,122,2019-01-08,cloudy,nan
1815,831,984,2019-05-08,partly-cloudy-day,nan
2082,952,1130,2019-05-02,partly-cloudy-day,nan
1807,920,887,2019-09-30,cloudy,nan
0,0,0,2019-02-02,clear-night,nan
1652,819,833,2019-11-17,partly-cloudy-day,nan
949,430,519,2019-01-08,cloudy,nan
1888,800,1088,2019-09-09,partly-cloudy-day,nan
56,50,6,2019-01-14,clear-night,nan
990,990,0,2019-02-19,clear-day,nan
3066,1509,1557,2019-04-23,clear-day,nan
1,0,1,2019-10-16,clear-night,nan
622,622,0,2019-02-19,clear-day,nan
1,0,1,2019-11-29,clear-night,Black Friday
419,221,198,2019-01-19,partly-cloudy-day,nan
110,91,19,2019-07-28,partly-cloudy-night,nan
2,1,1,2019-06-05,clear-night,nan
1886,856,1030,2019-06-17,cloudy,nan
4012,2012,2000,2019-01-01,partly-cloudy-day,New Year's Day
0,0,0,2019-12-18,partly-cloudy-night,nan
2,1,1,2019-10-24,clear-night,nan
28,23,5,2019-10-29,rain,nan
863,435,428,2019-06-16,cloudy,Father's Day
88,28,60,2019-11-12,cloudy,nan
1616,647,969,2019-09-25,partly-cloudy-day,nan
21,13,8,2019-02-13,cloudy,nan
325,181,144,2019-01-25,partly-cloudy-day,nan
337,167,170,2019-01-16,cloudy,nan
0,0,0,2019-05-29,partly-cloudy-night,nan
363,136,227,2019-09-04,partly-cloudy-day,nan
279,152,127,2019-12-26,partly-cloudy-day,nan
1,0,1,2019-12-28,clear-night,nan
49,29,20,2019-09-11,clear-night,nan
0,0,0,2019-01-30,clear-night,nan
10,0,10,2019-12-09,cloudy,nan
416,145,271,2019-05-20,partly-cloudy-day,nan
1194,557,637,2019-08-28,rain,nan
6,0,6,2019-12-20,clear-night,nan
1654,702,952,2019-07-09,clear-day,nan
0,0,0,2019-11-07,clear-night,nan
820,489,331,2019-11-10,partly-cloudy-day,nan
1493,716,777,2019-08-20,clear-day,nan
1101,551,550,2019-05-14,cloudy,nan
20,14,6,2019-06-25,partly-cloudy-night,nan
8,5,3,2019-01-21,clear-night,Martin Luther King Jr. Day
8,7,1,2019-03-19,clear-night,nan
722,166,556,2019-08-08,partly-cloudy-night,nan
1,0,1,2019-02-05,clear-night,nan
1163,591,572,2019-11-16,clear-day,nan
538,323,215,2019-03-16,partly-cloudy-day,nan
2557,1222,1335,2019-05-25,partly-cloudy-day,nan
19,17,2,2019-11-21,clear-night,nan
2,0,2,2019-11-29,clear-night,nan
0,0,0,2019-05-07,partly-cloudy-night,nan
0,0,0,2019-04-12,cloudy,nan
1642,959,683,2019-10-23,clear-day,nan
1586,735,851,2019-07-18,cloudy,nan
179,89,90,2019-06-02,partly-cloudy-day,nan
1574,744,830,2019-02-22,clear-day,nan
18,11,7,2019-12-09,rain,nan
0,0,0,2019-11-16,clear-night,nan
76,60,16,2019-09-05,partly-cloudy-night,nan
1715,843,872,2019-02-21,rain,nan
883,538,345,2019-09-29,partly-cloudy-day,nan
54,48,6,2019-10-25,partly-cloudy-night,nan
2909,1322,1587,2019-06-22,partly-cloudy-day,nan
10,5,5,2019-01-20,rain,nan
1,0,1,2019-11-28,cloudy,Thanksgiving Day
193,101,92,2019-06-09,clear-day,nan
1751,800,951,2019-08-20,partly-cloudy-day,nan
97,62,35,2019-11-11,clear-night,Veterans Day
1441,767,674,2019-09-20,clear-day,nan
479,238,241,2019-04-08,cloudy,nan
11,8,3,2019-04-05,rain,nan
0,0,0,2019-09-29,clear-night,nan
60,30,30,2019-11-25,clear-night,nan
1920,1137,783,2019-12-21,clear-day,nan
1569,761,808,2019-07-29,partly-cloudy-day,nan
136,79,57,2019-01-06,cloudy,nan
869,594,275,2019-06-08,clear-day,nan
0,0,0,2019-09-13,partly-cloudy-night,nan
1596,778,818,2019-04-03,clear-day,nan
2362,1077,1285,2019-03-24,clear-day,nan
3430,1547,1883,2019-03-30,partly-cloudy-day,nan
56,37,19,2019-10-18,partly-cloudy-night,nan
2525,1281,1244,2019-08-03,partly-cloudy-day,nan
2032,1018,1014,2019-08-05,partly-cloudy-day,nan
29,23,6,2019-08-10,clear-night,nan
1675,772,903,2019-09-07,partly-cloudy-day,nan
160,76,84,2019-06-07,clear-day,nan
4,1,3,2019-02-24,partly-cloudy-night,nan
41,27,14,2019-03-18,clear-night,nan
1447,636,811,2019-03-15,partly-cloudy-day,nan
256,123,133,2019-05-11,partly-cloudy-day,nan
178,79,99,2019-12-22,clear-night,nan
236,98,138,2019-07-01,clear-day,nan
22,15,7,2019-12-03,cloudy,nan
2242,958,1284,2019-09-22,partly-cloudy-day,nan
2,1,1,2019-01-15,clear-night,nan
0,0,0,2019-03-21,cloudy,nan
1137,526,611,2019-11-20,partly-cloudy-day,nan
1297,692,605,2019-05-28,cloudy,nan
99,58,41,2019-09-15,partly-cloudy-night,nan
2667,1299,1368,2019-06-09,clear-day,nan
0,0,0,2019-02-15,partly-cloudy-night,nan
3,2,1,2019-08-19,clear-night,nan
2618,1130,1488,2019-08-03,partly-cloudy-day,nan
997,510,487,2019-01-20,partly-cloudy-day,nan
4,1,3,2019-01-25,partly-cloudy-night,nan
1,0,1,2019-06-22,clear-night,nan
1532,699,833,2019-12-16,cloudy,nan
18,0,18,2019-12-13,rain,nan
0,0,0,2019-10-05,clear-night,nan
1733,717,1016,2019-12-06,cloudy,nan
167,119,48,2019-11-03,clear-night,Daylight Saving Time ends
0,0,0,2019-03-11,clear-night,nan
1470,576,894,2019-04-07,clear-day,nan
0,0,0,2019-09-21,clear-night,nan
0,0,0,2019-03-06,partly-cloudy-night,nan
961,562,399,2019-07-28,clear-day,nan
3125,1321,1804,2019-04-23,clear-day,nan
0,0,0,2019-09-26,clear-night,nan
2,0,2,2019-11-12,clear-night,nan
2826,1125,1701,2019-04-14,cloudy,nan
1623,866,757,2019-06-26,clear-day,nan
964,444,520,2019-12-10,rain,nan
1738,798,940,2019-02-09,clear-day,nan
1,0,1,2019-04-17,cloudy,nan
259,136,123,2019-04-19,partly-cloudy-day,nan
178,91,87,2019-06-10,cloudy,nan
3,0,3,2019-05-01,cloudy,nan
1743,765,978,2019-02-03,partly-cloudy-day,nan
11,5,6,2019-07-20,clear-night,nan
29,0,29,2019-12-08,clear-night,nan
2,0,2,2019-12-27,cloudy,nan
3033,1498,1535,2019-07-27,partly-cloudy-day,nan
42,28,14,2019-05-31,clear-night,nan
0,0,0,2019-03-11,partly-cloudy-night,nan
0,0,0,2019-05-23,partly-cloudy-night,nan
1871,791,1080,2019-05-29,cloudy,nan
59,39,20,2019-07-19,cloudy,nan
10,6,4,2019-05-20,clear-night,nan
2513,1135,1378,2019-05-19,clear-day,nan
75,29,46,2019-05-13,cloudy,nan
550,292,258,2019-07-17,partly-cloudy-day,nan
0,0,0,2019-03-27,clear-night,nan
43,0,43,2019-10-24,clear-night,nan
11,3,8,2019-01-15,clear-night,nan
15,14,1,2019-12-31,cloudy,nan
3291,1458,1833,2019-09-14,cloudy,nan
1861,1147,714,2019-10-19,clear-day,nan
2,1,1,2019-02-17,clear-night,nan
25,9,16,2019-08-23,clear-night,nan
2761,1318,1443,2019-09-21,clear-day,nan
1774,831,943,2019-06-21,rain,nan
30,0,30,2019-11-23,rain,nan
41,40,1,2019-03-07,clear-night,nan
2205,1053,1152,2019-02-23,clear-day,nan
891,539,352,2019-03-14,partly-cloudy-day,nan
258,96,162,2019-02-20,snow,nan
0,0,0,2019-11-05,partly-cloudy-night,nan
0,0,0,2019-08-16,partly-cloudy-night,nan
2015,1014,1001,2019-05-07,clear-day,nan
17,11,6,2019-05-09,cloudy,nan
203,114,89,2019-06-10,rain,nan
1868,863,1005,2019-09-16,partly-cloudy-day,nan
1974,1063,911,2019-08-01,partly-cloudy-day,nan
139,60,79,2019-12-01,clear-night,nan
820,368,452,2019-02-25,clear-day,nan
90,76,14,2019-01-27,partly-cloudy-night,nan
1,0,1,2019-06-07,clear-night,nan
0,0,0,2019-07-23,rain,nan
0,0,0,2019-10-20,clear-night,nan
77,49,28,2019-10-07,cloudy,nan
0,0,0,2019-08-05,clear-night,nan
104,70,34,2019-04-13,clear-night,nan
0,0,0,2019-11-01,clear-night,nan
66,57,9,2019-08-08,rain,nan
95,59,36,2019-02-20,cloudy,nan
27,15,12,2019-07-30,clear-night,nan
2544,1276,1268,2019-06-23,clear-day,nan
1401,794,607,2019-06-04,clear-day,nan
0,0,0,2019-04-09,partly-cloudy-night,nan
810,432,378,2019-01-23,cloudy,nan
63,58,5,2019-02-07,cloudy,nan
209,115,94,2019-01-02,clear-night,nan
303,117,186,2019-11-19,cloudy,nan
2161,976,1185,2019-04-22,partly-cloudy-day,Easter Monday
3764,2273,1491,2019-12-28,clear-day,nan
978,482,496,2019-12-19,clear-day,nan
1428,681,747,2019-03-27,clear-day,nan
1142,499,643,2019-02-28,clear-day,nan
3599,1518,2081,2019-08-10,partly-cloudy-day,nan
1099,469,630,2019-02-26,partly-cloudy-day,nan
1935,920,1015,2019-04-04,clear-day,nan
2365,1284,1081,2019-08-03,partly-cloudy-day,nan
0,0,0,2019-09-27,clear-night,nan
36,0,36,2019-08-06,partly-cloudy-night,nan
1412,690,722,2019-03-22,cloudy,nan
288,142,146,2019-05-03,cloudy,nan
1,0,1,2019-10-09,partly-cloudy-night,nan
2,0,2,2019-10-05,clear-night,nan
63,48,15,2019-09-05,partly-cloudy-night,nan
0,0,0,2019-10-07,cloudy,nan
0,0,0,2019-06-04,clear-night,nan
2,0,2,2019-11-19,cloudy,nan
61,52,9,2019-09-15,partly-cloudy-night,nan
1591,818,773,2019-04-11,cloudy,nan
488,229,259,2019-12-30,rain,nan
612,405,207,2019-05-26,partly-cloudy-day,nan
229,148,81,2019-12-29,partly-cloudy-night,nan
0,0,0,2019-04-15,partly-cloudy-night,Tax Day
348,164,184,2019-09-25,clear-day,nan
0,0,0,2019-11-25,clear-night,nan
1,0,1,2019-02-01,clear-night,nan
0,0,0,2019-11-08,partly-cloudy-night,nan
96,50,46,2019-03-06,clear-day,nan
0,0,0,2019-07-20,clear-night,nan
1763,875,888,2019-03-15,partly-cloudy-day,nan
1298,623,675,2019-12-13,cloudy,nan
1399,723,676,2019-05-10,partly-cloudy-day,nan
1,0,1,2019-01-15,clear-night,nan
39,28,11,2019-09-03,clear-night,nan
1,0,1,2019-09-22,clear-night,nan
848,502,346,2019-10-12,cloudy,nan
0,0,0,2019-06-19,cloudy,nan
1472,612,860,2019-11-07,cloudy,nan
0,0,0,2019-03-21,partly-cloudy-night,nan
255,115,140,2019-10-06,cloudy,nan
5,4,1,2019-12-18,partly-cloudy-night,nan
0,0,0,2019-03-19,clear-night,nan
1,0,1,2019-11-21,clear-night,nan
1,0,1,2019-06-02,partly-cloudy-night,nan
498,272,226,2019-02-22,clear-day,nan
0,0,0,2019-11-03,clear-night,Daylight Saving Time ends
1945,1116,829,2019-08-25,partly-cloudy-day,nan
2343,1166,1177,2019-07-26,partly-cloudy-day,nan
2266,1168,1098,2019-11-02,clear-day,nan
874,447,427,2019-10-04,clear-day,nan
130,53,77,2019-04-29,clear-night,nan
1876,924,952,2019-10-15,clear-day,nan
2950,1400,1550,2019-04-17,clear-day,nan
1641,983,658,2019-06-15,partly-cloudy-day,nan
0,0,0,2019-03-30,partly-cloudy-night,nan
40,18,22,2019-05-23,rain,nan
0,0,0,2019-09-11,partly-cloudy-night,nan
81,38,43,2019-01-30,clear-night,nan
4,0,4,2019-12-14,rain,nan
1599,842,757,2019-08-23,cloudy,nan
2761,1272,1489,2019-06-09,clear-day,nan
3,2,1,2019-08-28,partly-cloudy-night,nan
2370,1066,1304,2019-08-06,partly-cloudy-day,nan
1937,890,1047,2019-02-17,clear-day,nan
0,0,0,2019-05-11,rain,nan
3,0,3,2019-04-12,cloudy,nan
95,56,39,2019-06-22,clear-night,nan
847,411,436,2019-05-05,cloudy,Cinco de Mayo
8,5,3,2019-03-06,clear-night,nan
2806,1204,1602,2019-03-24,clear-day,nan
0,0,0,2019-11-27,clear-night,nan
213,83,130,2019-01-28,clear-day,nan
0,0,0,2019-03-17,clear-night,St. Patrick's Day
374,193,181,2019-10-28,partly-cloudy-night,nan
2367,1111,1256,2019-05-26,clear-day,nan
193,81,112,2019-02-12,fog,nan
1,0,1,2019-11-10,partly-cloudy-night,nan
1,0,1,2019-12-23,clear-night,nan
0,0,0,2019-11-26,clear-night,nan
64,0,64,2019-11-12,clear-night,nan
2042,940,1102,2019-10-11,cloudy,nan
62,51,11,2019-09-21,clear-night,nan
61,0,61,2019-12-23,clear-night,Christmas Eve
1,0,1,2019-03-12,clear-night,nan
0,0,0,2019-04-10,clear-night,nan
2329,1201,1128,2019-08-11,partly-cloudy-day,nan
33,30,3,2019-09-18,partly-cloudy-night,nan
1493,716,777,2019-01-26,partly-cloudy-day,nan
2227,1071,1156,2019-07-12,partly-cloudy-day,nan
4,2,2,2019-10-03,cloudy,nan
18,14,4,2019-11-02,cloudy,Daylight Saving Time ends
134,86,48,2019-09-21,clear-night,nan
0,0,0,2019-07-12,partly-cloudy-night,nan
25,24,1,2019-11-07,rain,nan
363,205,158,2019-07-27,clear-day,nan
3,2,1,2019-07-04,partly-cloudy-day,nan
0,0,0,2019-10-30,cloudy,nan
271,125,146,2019-10-10,partly-cloudy-night,nan
2,0,2,2019-04-16,cloudy,nan
45,35,10,2019-06-26,partly-cloudy-night,nan
35,13,22,2019-09-07,partly-cloudy-night,nan
942,414,528,2019-05-20,partly-cloudy-day,nan
57,45,12,2019-08-22,rain,nan
337,144,193,2019-08-07,partly-cloudy-day,nan
1001,448,553,2019-10-22,fog,nan
621,335,286,2019-09-23,partly-cloudy-day,nan
72,44,28,2019-02-20,cloudy,nan
6,3,3,2019-07-07,partly-cloudy-night,nan
441,249,192,2019-01-07,partly-cloudy-day,nan
19,16,3,2019-09-29,clear-night,nan
25,21,4,2019-09-27,clear-night,nan
1904,947,957,2019-02-23,clear-day,nan
65,56,9,2019-05-04,cloudy,Cinco de Mayo
11,10,1,2019-11-21,clear-night,nan
357,186,171,2019-02-26,clear-day,nan
5,0,5,2019-04-05,rain,nan
22,9,13,2019-07-07,partly-cloudy-night,nan
1102,482,620,2019-11-14,partly-cloudy-day,nan
226,48,178,2019-07-17,partly-cloudy-day,nan
368,187,181,2019-08-18,cloudy,nan
0,0,0,2019-04-09,cloudy,nan
1,0,1,2019-11-13,clear-night,nan
19,18,1,2019-01-26,clear-night,nan
1826,968,858,2019-03-23,clear-day,nan
2248,1091,1157,2019-04-29,clear-day,nan
583,356,227,2019-03-31,partly-cloudy-day,nan
4,3,1,2019-03-03,snow,nan
0,0,0,2019-03-24,clear-night,nan
2536,1045,1491,2019-04-07,partly-cloudy-day,nan
1,0,1,2019-11-04,clear-night,nan
46,43,3,2019-02-13,clear-night,nan
22,18,4,2019-04-23,partly-cloudy-night,nan
3,1,2,2019-06-21,cloudy,nan
71,63,8,2019-07-27,clear-night,nan
348,121,227,2019-03-04,partly-cloudy-night,nan
36,33,3,2019-12-02,snow,nan
1,0,1,2019-09-16,clear-night,nan
13,3,10,2019-09-16,partly-cloudy-night,nan
1640,806,834,2019-04-18,cloudy,nan
30,29,1,2019-02-06,clear-night,nan
2338,1092,1246,2019-08-23,partly-cloudy-day,nan
1650,726,924,2019-12-13,cloudy,nan
37,27,10,2019-08-16,partly-cloudy-night,nan
10,0,10,2019-03-14,clear-night,nan
2368,1321,1047,2019-01-01,partly-cloudy-day,New Year's Day
613,368,245,2019-12-25,clear-day,Christmas Day
2941,1498,1443,2019-10-26,clear-day,nan
0,0,0,2019-08-31,clear-night,nan
3638,1557,2081,2019-06-22,partly-cloudy-day,nan
264,76,188,2019-06-18,rain,nan
1823,849,974,2019-07-25,partly-cloudy-day,nan
559,211,348,2019-05-15,clear-day,nan
0,0,0,2019-11-04,clear-night,nan
0,0,0,2019-07-09,clear-night,nan
1018,478,540,2019-03-01,cloudy,nan
34,0,34,2019-12-08,clear-night,nan
1,0,1,2019-05-22,clear-night,nan
1820,955,865,2019-03-04,partly-cloudy-day,nan
311,160,151,2019-11-01,clear-night,nan
49,19,30,2019-01-31,clear-night,nan
8,1,7,2019-07-04,clear-day,Independence Day
1,0,1,2019-01-04,clear-night,nan
1336,726,610,2019-06-26,clear-day,nan
0,0,0,2019-06-25,partly-cloudy-night,nan
0,0,0,2019-03-08,clear-night,nan
80,38,42,2019-01-08,cloudy,nan
1281,600,681,2019-02-15,partly-cloudy-day,nan
68,54,14,2019-02-10,partly-cloudy-night,nan
2173,911,1262,2019-02-17,clear-day,nan
6,3,3,2019-01-17,clear-night,nan
1910,869,1041,2019-04-15,wind,Tax Day
1,0,1,2019-07-13,clear-night,nan
2050,1146,904,2019-08-06,partly-cloudy-day,nan
1552,709,843,2019-09-11,clear-day,nan
0,0,0,2019-11-14,clear-night,nan
1791,849,942,2019-07-15,clear-day,nan
1984,882,1102,2019-03-11,clear-day,nan
105,80,25,2019-08-25,partly-cloudy-night,nan
0,0,0,2019-12-19,partly-cloudy-night,nan
1,0,1,2019-12-30,cloudy,New Year's Eve
6,6,0,2019-03-16,partly-cloudy-night,nan
0,0,0,2019-05-07,cloudy,nan
1724,694,1030,2019-06-20,cloudy,nan
21,11,10,2019-05-10,partly-cloudy-night,nan
0,0,0,2019-04-30,rain,nan
61,0,61,2019-12-04,cloudy,nan
2111,927,1184,2019-08-12,clear-day,nan
41,21,20,2019-05-03,cloudy,nan
2126,1376,750,2019-04-24,clear-day,nan
1,0,1,2019-02-12,partly-cloudy-night,nan
2565,1137,1428,2019-04-24,clear-day,nan
0,0,0,2019-10-28,clear-night,nan
268,113,155,2019-06-14,clear-day,nan
638,320,318,2019-11-06,clear-day,nan
1459,847,612,2019-06-27,partly-cloudy-day,nan
1418,585,833,2019-03-13,clear-day,nan
1334,571,763,2019-03-26,clear-day,nan
2,0,2,2019-06-26,clear-night,nan
19,9,10,2019-06-30,partly-cloudy-night,nan
1984,982,1002,2019-05-03,cloudy,nan
204,107,97,2019-12-23,clear-night,nan
1035,534,501,2019-10-27,cloudy,nan
1,0,1,2019-10-16,partly-cloudy-night,nan
214,102,112,2019-10-17,cloudy,nan
0,0,0,2019-12-02,cloudy,nan
0,0,0,2019-01-14,clear-night,nan
9,5,4,2019-08-27,clear-night,nan
4,2,2,2019-06-15,clear-night,nan
19,13,6,2019-08-17,cloudy,nan
1658,840,818,2019-09-27,clear-day,nan
252,90,162,2019-12-18,clear-day,nan
4,2,2,2019-05-08,clear-night,nan
235,104,131,2019-11-21,clear-day,nan
678,350,328,2019-11-13,clear-day,nan
1919,834,1085,2019-01-19,cloudy,nan
36,30,6,2019-01-24,partly-cloudy-night,nan
0,0,0,2019-02-27,cloudy,nan
3,0,3,2019-12-03,clear-night,nan
538,255,283,2019-07-21,partly-cloudy-day,nan
2081,1013,1068,2019-05-16,partly-cloudy-day,nan
748,432,316,2019-07-31,rain,nan
12,10,2,2019-01-25,clear-night,nan
60,51,9,2019-09-18,partly-cloudy-night,nan
59,50,9,2019-09-22,clear-night,nan
1480,676,804,2019-05-01,cloudy,nan
443,212,231,2019-03-20,clear-day,nan
3,0,3,2019-10-18,cloudy,nan
240,111,129,2019-09-29,clear-day,nan
19,13,6,2019-04-27,clear-night,nan
2734,1187,1547,2019-09-14,cloudy,nan
6,5,1,2019-02-23,clear-night,nan
278,114,164,2019-05-12,rain,Mother's Day
6,3,3,2019-06-13,partly-cloudy-night,nan
664,379,285,2019-11-09,clear-day,nan
1890,863,1027,2019-08-01,partly-cloudy-day,nan
1453,842,611,2019-07-19,partly-cloudy-day,nan
1362,675,687,2019-01-26,partly-cloudy-day,nan
2993,1349,1644,2019-05-27,partly-cloudy-day,Memorial Day
2064,965,1099,2019-12-06,cloudy,nan
31,30,1,2019-12-23,clear-night,Christmas Eve
0,0,0,2019-08-22,clear-night,nan
2214,913,1301,2019-04-29,clear-day,nan
215,77,138,2019-05-21,partly-cloudy-day,nan
0,0,0,2019-01-06,clear-night,nan
527,303,224,2019-09-12,partly-cloudy-day,nan
1,0,1,2019-09-30,partly-cloudy-night,nan
119,44,75,2019-01-21,clear-night,Martin Luther King Jr. Day
386,179,207,2019-11-18,cloudy,nan
301,142,159,2019-05-06,clear-day,nan
83,45,38,2019-01-02,cloudy,nan
823,360,463,2019-04-05,cloudy,nan
551,315,236,2019-11-17,partly-cloudy-day,nan
0,0,0,2019-07-08,partly-cloudy-night,nan
90,65,25,2019-06-22,clear-night,nan
1970,899,1071,2019-09-03,partly-cloudy-day,nan
913,432,481,2019-02-06,partly-cloudy-day,nan
20,20,0,2019-11-08,clear-night,nan
2194,1059,1135,2019-04-18,partly-cloudy-day,nan
589,296,293,2019-06-27,clear-day,nan
1962,939,1023,2019-11-26,clear-day,nan
2080,908,1172,2019-07-14,partly-cloudy-day,nan
0,0,0,2019-12-06,clear-night,nan
1883,832,1051,2019-05-22,clear-day,nan
171,51,120,2019-06-21,rain,nan
2656,1176,1480,2019-10-18,partly-cloudy-day,nan
359,205,154,2019-10-19,clear-day,nan
1086,654,432,2019-09-01,partly-cloudy-day,nan
54,46,8,2019-07-03,clear-night,Independence Day
1,0,1,2019-10-29,cloudy,nan
1690,979,711,2019-07-20,partly-cloudy-day,nan
2111,965,1146,2019-09-20,clear-day,nan
21,16,5,2019-12-18,clear-night,nan
2106,910,1196,2019-06-03,partly-cloudy-day,nan
90,88,2,2019-02-05,clear-night,nan
0,0,0,2019-09-17,partly-cloudy-night,nan
6,4,2,2019-07-03,partly-cloudy-night,nan
58,50,8,2019-05-18,partly-cloudy-night,nan
1554,618,936,2019-09-25,partly-cloudy-day,nan
20,0,20,2019-10-03,rain,nan
1869,960,909,2019-02-21,clear-day,nan
1313,728,585,2019-06-25,partly-cloudy-day,nan
6,0,6,2019-12-12,clear-night,nan
120,48,72,2019-02-11,cloudy,nan
1687,750,937,2019-11-04,clear-day,nan
1064,629,435,2019-10-29,cloudy,nan
1,0,1,2019-10-11,partly-cloudy-night,nan
655,368,287,2019-03-09,clear-day,nan
536,279,257,2019-04-30,cloudy,nan
16,14,2,2019-09-01,clear-night,nan
1550,483,1067,2019-12-28,clear-day,nan
1060,566,494,2019-04-30,partly-cloudy-day,nan
1791,884,907,2019-08-29,clear-day,nan
66,58,8,2019-09-19,clear-night,nan
2,1,1,2019-05-13,cloudy,nan
2,1,1,2019-03-22,partly-cloudy-night,nan
153,72,81,2019-12-15,partly-cloudy-night,nan
1331,606,725,2019-10-29,cloudy,nan
1730,892,838,2019-04-12,cloudy,nan
242,122,120,2019-07-13,clear-day,nan
686,296,390,2019-05-17,partly-cloudy-day,nan
981,545,436,2019-10-07,cloudy,nan
206,93,113,2019-10-16,rain,nan
0,0,0,2019-02-05,partly-cloudy-night,nan
28,27,1,2019-04-26,cloudy,nan
4,3,1,2019-11-03,partly-cloudy-night,Daylight Saving Time ends
1,0,1,2019-03-01,cloudy,nan
2133,1068,1065,2019-11-11,clear-day,Veterans Day
3,1,2,2019-03-25,cloudy,nan
38,35,3,2019-09-19,clear-night,nan
68,62,6,2019-10-23,clear-night,nan
955,501,454,2019-10-23,clear-day,nan
1787,849,938,2019-05-22,clear-day,nan
277,148,129,2019-05-02,cloudy,nan
458,297,161,2019-01-11,clear-day,nan
70,41,29,2019-01-20,rain,nan
775,392,383,2019-01-10,partly-cloudy-day,nan
51,14,37,2019-05-25,partly-cloudy-night,nan
1,0,1,2019-05-24,clear-night,nan
1520,741,779,2019-09-05,partly-cloudy-day,nan
1650,1002,648,2019-06-14,partly-cloudy-day,nan
1766,839,927,2019-07-09,clear-day,nan
2,0,2,2019-11-16,clear-night,nan
1632,784,848,2019-06-28,partly-cloudy-day,nan
147,74,73,2019-06-28,partly-cloudy-day,nan
1834,789,1045,2019-03-18,partly-cloudy-day,nan
416,194,222,2019-05-30,cloudy,nan
1914,1139,775,2019-10-13,partly-cloudy-day,nan
1827,683,1144,2019-05-11,cloudy,nan
2331,1118,1213,2019-07-13,clear-day,nan
1104,492,612,2019-05-31,clear-day,nan
1313,659,654,2019-09-02,partly-cloudy-day,Labor Day
2602,1314,1288,2019-08-17,partly-cloudy-day,nan
658,334,324,2019-10-25,partly-cloudy-night,nan
0,0,0,2019-09-07,partly-cloudy-night,nan
1164,433,731,2019-05-24,clear-day,nan
1706,1031,675,2019-04-13,cloudy,nan
1,0,1,2019-01-27,clear-night,nan
591,338,253,2019-04-20,rain,nan
7,0,7,2019-03-21,rain,nan
341,184,157,2019-07-04,clear-day,Independence Day
2037,1162,875,2019-06-22,clear-day,nan
1,1,0,2019-05-25,clear-night,nan
6,4,2,2019-02-24,partly-cloudy-night,nan
735,300,435,2019-03-10,cloudy,Daylight Saving Time starts
8,4,4,2019-11-23,clear-night,nan
191,82,109,2019-01-19,cloudy,nan
0,0,0,2019-10-22,cloudy,nan
58,42,16,2019-10-13,clear-night,nan
1063,678,385,2019-12-29,cloudy,nan
1969,1176,793,2019-07-15,partly-cloudy-day,nan
0,0,0,2019-04-09,partly-cloudy-night,nan
0,0,0,2019-02-15,clear-night,nan
1675,716,959,2019-06-06,partly-cloudy-day,nan
18,17,1,2019-11-16,clear-night,nan
169,77,92,2019-04-14,partly-cloudy-day,nan
1575,818,757,2019-09-25,clear-day,nan
1,0,1,2019-10-18,cloudy,nan
1,0,1,2019-07-22,partly-cloudy-night,nan
45,0,45,2019-07-11,rain,nan
1849,801,1048,2019-05-29,cloudy,nan
1956,1064,892,2019-05-22,clear-day,nan
18,8,10,2019-07-16,clear-night,nan
8,6,2,2019-03-29,cloudy,nan
1358,560,798,2019-09-04,partly-cloudy-day,nan
477,225,252,2019-10-20,rain,nan
1741,774,967,2019-09-26,partly-cloudy-day,nan
1948,825,1123,2019-05-30,cloudy,nan
675,291,384,2019-08-28,cloudy,nan
1765,850,915,2019-08-04,partly-cloudy-day,nan
55,25,30,2019-03-02,cloudy,nan
107,68,39,2019-06-30,partly-cloudy-night,nan
2,0,2,2019-10-19,clear-night,nan
318,181,137,2019-10-09,rain,nan
0,0,0,2019-03-27,clear-night,nan
259,130,129,2019-05-09,cloudy,nan
896,461,435,2019-12-01,cloudy,nan
1,0,1,2019-01-05,rain,nan
0,0,0,2019-07-11,cloudy,nan
0,0,0,2019-07-26,clear-night,nan
1343,810,533,2019-04-28,cloudy,nan
1371,709,662,2019-05-08,clear-day,nan
6,6,0,2019-02-19,clear-night,nan
3117,1475,1642,2019-08-24,partly-cloudy-day,nan
1343,697,646,2019-07-18,cloudy,nan
3,0,3,2019-11-01,clear-night,nan
7,6,1,2019-03-23,clear-night,nan
0,0,0,2019-01-16,clear-night,nan
10,0,10,2019-10-27,cloudy,nan
0,0,0,2019-01-24,cloudy,nan
921,445,476,2019-11-20,cloudy,nan
1,0,1,2019-09-25,clear-night,nan
82,81,1,2019-11-14,clear-night,nan
36,32,4,2019-02-08,clear-night,nan
0,0,0,2019-03-12,partly-cloudy-night,nan
656,319,337,2019-01-23,cloudy,nan
11,4,7,2019-05-01,cloudy,nan
2080,1103,977,2019-09-09,partly-cloudy-day,nan
0,0,0,2019-11-05,clear-night,nan
577,244,333,2019-04-23,clear-day,nan
640,348,292,2019-03-06,partly-cloudy-day,nan
2329,1072,1257,2019-01-04,clear-day,nan
0,0,0,2019-03-23,cloudy,nan
0,0,0,2019-01-21,partly-cloudy-night,Martin Luther King Jr. Day
811,408,403,2019-01-09,partly-cloudy-day,nan
943,482,461,2019-07-18,rain,nan
271,110,161,2019-11-26,clear-night,nan
1487,674,813,2019-04-30,cloudy,nan
2685,1250,1435,2019-06-23,clear-day,nan
259,87,172,2019-04-28,partly-cloudy-night,nan
1852,943,909,2019-08-19,partly-cloudy-day,nan
1,0,1,2019-01-28,clear-night,nan
1995,851,1144,2019-03-17,clear-day,St. Patrick's Day
1560,887,673,2019-10-18,partly-cloudy-day,nan
2577,1174,1403,2019-09-08,partly-cloudy-day,nan
2,1,1,2019-10-08,rain,nan
0,0,0,2019-05-13,cloudy,nan
326,175,151,2019-05-04,cloudy,nan
2191,1156,1035,2019-08-29,clear-day,nan
1671,897,774,2019-11-01,clear-day,nan
317,143,174,2019-08-24,partly-cloudy-night,nan
0,0,0,2019-02-18,rain,Presidents' Day (regional holiday)
84,67,17,2019-09-10,partly-cloudy-night,nan
990,581,409,2019-08-13,partly-cloudy-day,nan
8,3,5,2019-07-26,clear-night,nan
2,1,1,2019-11-13,clear-night,nan
4,0,4,2019-07-23,rain,nan
1710,760,950,2019-03-28,clear-day,nan
0,0,0,2019-07-04,clear-night,Independence Day
0,0,0,2019-02-25,partly-cloudy-night,nan
840,427,413,2019-03-18,clear-day,nan
273,151,122,2019-03-21,rain,nan
44,36,8,2019-10-13,partly-cloudy-night,nan
23,10,13,2019-07-14,clear-night,nan
66,65,1,2019-11-05,clear-night,nan
1,0,1,2019-12-11,rain,nan
42,29,13,2019-05-28,clear-night,nan
778,304,474,2019-09-06,cloudy,nan
2936,1296,1640,2019-05-24,partly-cloudy-day,nan
1075,600,475,2019-11-22,cloudy,nan
78,39,39,2019-04-07,clear-night,nan
1521,614,907,2019-02-10,clear-day,nan
8,2,6,2019-03-18,partly-cloudy-night,nan
208,119,89,2019-09-24,clear-night,nan
2384,1149,1235,2019-09-13,partly-cloudy-day,nan
466,208,258,2019-01-29,cloudy,nan
1047,592,455,2019-11-11,clear-day,Veterans Day
912,423,489,2019-02-07,cloudy,nan
12,3,9,2019-08-21,partly-cloudy-night,nan
2,0,2,2019-11-13,clear-night,nan
1209,614,595,2019-06-11,partly-cloudy-day,nan
75,62,13,2019-07-28,partly-cloudy-night,nan
113,47,66,2019-05-13,cloudy,nan
77,58,19,2019-01-22,partly-cloudy-night,nan
2336,997,1339,2019-08-18,partly-cloudy-day,nan
62,60,2,2019-12-07,clear-night,nan
2047,1049,998,2019-12-22,clear-day,nan
365,161,204,2019-05-28,partly-cloudy-day,nan
699,393,306,2019-04-02,clear-day,nan
0,0,0,2019-01-25,cloudy,nan
1103,478,625,2019-10-31,rain,Halloween
35,30,5,2019-10-12,partly-cloudy-night,nan
903,473,430,2019-04-08,partly-cloudy-day,nan
268,135,133,2019-01-21,partly-cloudy-day,Martin Luther King Jr. Day
1,0,1,2019-03-10,fog,Daylight Saving Time starts
27,25,2,2019-02-28,clear-night,nan
197,90,107,2019-04-03,clear-day,nan
30,27,3,2019-07-09,clear-night,nan
958,423,535,2019-11-20,cloudy,nan
208,111,97,2019-09-05,partly-cloudy-night,nan
38,17,21,2019-08-14,partly-cloudy-night,nan
803,425,378,2019-07-17,clear-day,nan
7,4,3,2019-03-05,clear-night,nan
0,0,0,2019-08-02,partly-cloudy-night,nan
0,0,0,2019-07-19,cloudy,nan
1391,574,817,2019-04-19,partly-cloudy-day,nan
16,15,1,2019-04-07,partly-cloudy-night,nan
1401,612,789,2019-06-13,cloudy,nan
14,13,1,2019-10-30,cloudy,Halloween
716,380,336,2019-06-24,clear-day,nan
782,362,420,2019-02-01,cloudy,nan
0,0,0,2019-10-17,cloudy,nan
56,54,2,2019-10-18,partly-cloudy-night,nan
0,0,0,2019-03-16,partly-cloudy-night,nan
823,351,472,2019-02-20,snow,nan
0,0,0,2019-02-07,cloudy,nan
0,0,0,2019-04-03,cloudy,nan
5,1,4,2019-06-01,clear-night,nan
1,0,1,2019-01-10,partly-cloudy-night,nan
25,22,3,2019-02-16,clear-night,nan
2547,1120,1427,2019-07-13,partly-cloudy-day,nan
18,12,6,2019-06-19,cloudy,nan
2022,863,1159,2019-11-25,partly-cloudy-day,nan
1483,715,768,2019-12-16,cloudy,nan
39,23,16,2019-06-05,cloudy,nan
1,0,1,2019-09-04,clear-night,nan
38,0,38,2019-10-19,clear-night,nan
0,0,0,2019-08-10,clear-night,nan
291,138,153,2019-04-25,clear-day,nan
0,0,0,2019-10-06,cloudy,nan
15,10,5,2019-05-05,rain,nan
86,55,31,2019-03-02,cloudy,nan
1330,557,773,2019-04-14,cloudy,nan
119,54,65,2019-01-05,cloudy,nan
107,104,3,2019-06-20,partly-cloudy-night,nan
0,0,0,2019-12-12,clear-night,nan
340,304,36,2019-12-09,rain,nan
0,0,0,2019-04-02,clear-night,nan
1056,1056,0,2019-02-19,clear-day,nan
1,0,1,2019-10-14,cloudy,Columbus Day (regional holiday)
1190,636,554,2019-05-20,partly-cloudy-day,nan
49,31,18,2019-06-16,partly-cloudy-night,nan
22,0,22,2019-03-29,partly-cloudy-night,nan
445,241,204,2019-05-19,partly-cloudy-day,nan
1,0,1,2019-02-12,partly-cloudy-night,nan
4,2,2,2019-02-27,cloudy,nan
0,0,0,2019-04-07,clear-night,nan
1385,619,766,2019-12-06,cloudy,nan
2546,1138,1408,2019-05-02,partly-cloudy-day,nan
1884,954,930,2019-08-02,partly-cloudy-day,nan
1586,707,879,2019-10-14,clear-day,Columbus Day (regional holiday)
2081,991,1090,2019-06-23,clear-day,nan
1800,807,993,2019-04-08,partly-cloudy-day,nan
2,0,2,2019-10-08,partly-cloudy-night,nan
1055,475,580,2019-03-07,cloudy,nan
2146,979,1167,2019-09-30,cloudy,nan
30,12,18,2019-07-05,cloudy,nan
1544,703,841,2019-02-23,partly-cloudy-day,nan
0,0,0,2019-11-29,clear-night,Black Friday
235,88,147,2019-01-16,partly-cloudy-day,nan
506,196,310,2019-05-08,partly-cloudy-day,nan
0,0,0,2019-02-05,partly-cloudy-night,nan
1296,773,523,2019-04-03,clear-day,nan
1519,790,729,2019-03-02,cloudy,nan
2,1,1,2019-04-21,partly-cloudy-night,Easter Sunday
2219,965,1254,2019-08-17,partly-cloudy-day,nan
191,93,98,2019-11-12,rain,nan
0,0,0,2019-09-02,partly-cloudy-night,Labor Day
0,0,0,2019-08-11,clear-night,nan
1205,471,734,2019-08-13,cloudy,nan
1136,606,530,2019-03-19,partly-cloudy-day,nan
462,228,234,2019-12-04,cloudy,nan
183,76,107,2019-03-28,clear-day,nan
1,0,1,2019-12-28,clear-night,nan
2838,1170,1668,2019-04-21,partly-cloudy-day,Easter Sunday
1325,669,656,2019-06-13,cloudy,nan
1328,753,575,2019-12-24,clear-day,Christmas Eve
1,0,1,2019-11-07,cloudy,nan
819,382,437,2019-04-26,rain,nan
29,16,13,2019-03-14,partly-cloudy-night,nan
0,0,0,2019-07-31,clear-night,nan
1802,863,939,2019-06-29,partly-cloudy-day,nan
507,287,220,2019-04-27,clear-day,nan
13,0,13,2019-12-05,partly-cloudy-night,nan
120,76,44,2019-03-17,clear-night,St. Patrick's Day
13,7,6,2019-12-19,partly-cloudy-night,nan
86,40,46,2019-06-19,cloudy,nan
0,0,0,2019-02-02,clear-night,nan
1,0,1,2019-08-05,partly-cloudy-night,nan
1,0,1,2019-05-02,fog,nan
0,0,0,2019-02-16,clear-night,nan
5,4,1,2019-10-11,cloudy,nan
1534,494,1040,2019-06-02,partly-cloudy-day,nan
1,0,1,2019-07-17,partly-cloudy-night,nan
35,12,23,2019-07-14,clear-night,nan
5,0,5,2019-12-17,rain,nan
2427,1098,1329,2019-05-07,clear-day,nan
2142,989,1153,2019-10-07,partly-cloudy-day,nan
37,16,21,2019-10-08,cloudy,nan
56,25,31,2019-03-25,partly-cloudy-night,nan
1680,739,941,2019-07-10,partly-cloudy-day,nan
1019,478,541,2019-12-03,partly-cloudy-day,nan
82,54,28,2019-06-08,clear-night,nan
1108,438,670,2019-05-30,cloudy,nan
0,0,0,2019-10-25,clear-night,nan
2037,945,1092,2019-11-16,clear-day,nan
0,0,0,2019-08-08,partly-cloudy-night,nan
20,18,2,2019-11-08,clear-night,nan
953,540,413,2019-05-25,partly-cloudy-day,nan
0,0,0,2019-02-23,clear-night,nan
50,48,2,2019-04-18,clear-night,nan
69,41,28,2019-03-08,clear-night,nan
1159,476,683,2019-07-30,partly-cloudy-day,nan
875,420,455,2019-03-10,cloudy,Daylight Saving Time starts
0,0,0,2019-11-19,rain,nan
2618,1492,1126,2019-08-10,clear-day,nan
0,0,0,2019-10-21,cloudy,nan
2484,1201,1283,2019-08-23,partly-cloudy-day,nan
0,0,0,2019-11-28,partly-cloudy-night,Thanksgiving Day
1,0,1,2019-12-15,cloudy,nan
322,172,150,2019-04-12,cloudy,nan
38,18,20,2019-02-25,partly-cloudy-night,nan
531,298,233,2019-06-05,partly-cloudy-day,nan
2209,1066,1143,2019-06-21,partly-cloudy-day,nan
138,63,75,2019-12-14,rain,nan
48,39,9,2019-06-12,partly-cloudy-night,nan
2063,997,1066,2019-10-15,clear-day,nan
1207,624,583,2019-01-25,partly-cloudy-day,nan
2685,1279,1406,2019-05-31,clear-day,nan
0,0,0,2019-02-22,clear-night,nan
0,0,0,2019-01-30,partly-cloudy-night,nan
1882,717,1165,2019-04-23,partly-cloudy-day,nan
1963,936,1027,2019-07-24,partly-cloudy-day,nan
835,470,365,2019-12-09,rain,nan
2,0,2,2019-02-10,clear-night,nan
195,86,109,2019-07-16,clear-day,nan
1,0,1,2019-02-03,clear-night,nan
662,272,390,2019-05-05,rain,Cinco de Mayo
3,1,2,2019-06-11,cloudy,nan
546,260,286,2019-02-27,cloudy,nan
2,1,1,2019-04-19,clear-night,nan
1018,508,510,2019-03-13,partly-cloudy-day,nan
3379,1456,1923,2019-10-12,partly-cloudy-day,nan
1742,751,991,2019-09-17,clear-day,nan
1,1,0,2019-12-07,clear-night,nan
3271,1529,1742,2019-10-12,partly-cloudy-day,nan
1713,962,751,2019-09-21,clear-day,nan
1,0,1,2019-02-10,clear-night,nan
1,0,1,2019-09-11,partly-cloudy-night,nan
839,336,503,2019-01-22,clear-day,nan
145,64,81,2019-04-01,clear-day,nan
459,226,233,2019-04-05,rain,nan
1506,729,777,2019-04-01,clear-day,nan
1733,782,951,2019-08-27,partly-cloudy-day,nan
0,0,0,2019-11-24,clear-night,nan
332,148,184,2019-10-09,cloudy,nan
0,0,0,2019-04-06,cloudy,nan
1785,743,1042,2019-04-10,partly-cloudy-day,nan
120,54,66,2019-01-14,partly-cloudy-night,nan
190,69,121,2019-07-20,clear-day,nan
3,0,3,2019-10-12,cloudy,nan
9,0,9,2019-11-15,clear-night,nan
1878,898,980,2019-03-03,partly-cloudy-day,nan
2,0,2,2019-02-25,clear-night,nan
211,68,143,2019-02-07,cloudy,nan
1,0,1,2019-09-22,clear-night,nan
1098,659,439,2019-03-29,cloudy,nan
0,0,0,2019-02-01,clear-night,nan
0,0,0,2019-05-26,cloudy,nan
1468,804,664,2019-03-11,clear-day,nan
36,0,36,2019-12-20,partly-cloudy-night,nan
49,25,24,2019-06-07,partly-cloudy-night,nan
7,5,2,2019-04-29,cloudy,nan
2073,898,1175,2019-06-04,partly-cloudy-day,nan
107,48,59,2019-10-03,rain,nan
42,21,21,2019-03-10,rain,Daylight Saving Time starts
46,11,35,2019-04-29,cloudy,nan
2413,1142,1271,2019-08-08,partly-cloudy-day,nan
1014,619,395,2019-09-28,clear-day,nan
1711,945,766,2019-04-06,partly-cloudy-day,nan
2742,1394,1348,2019-01-02,partly-cloudy-day,nan
231,106,125,2019-07-12,partly-cloudy-day,nan
868,442,426,2019-04-04,clear-day,nan
2,0,2,2019-11-28,clear-night,Black Friday
917,565,352,2019-06-09,clear-day,nan
2289,1013,1276,2019-11-03,partly-cloudy-day,Daylight Saving Time ends
2454,950,1504,2019-10-06,cloudy,nan
116,48,68,2019-03-21,cloudy,nan
1487,865,622,2019-07-14,partly-cloudy-day,nan
33,32,1,2019-03-30,clear-night,nan
2266,910,1356,2019-07-28,partly-cloudy-day,nan
111,66,45,2019-04-11,partly-cloudy-night,nan
14,0,14,2019-11-03,partly-cloudy-night,Daylight Saving Time ends
473,277,196,2019-06-20,fog,nan
214,94,120,2019-08-13,partly-cloudy-night,nan
183,111,72,2019-09-09,partly-cloudy-night,nan
10,9,1,2019-11-30,clear-night,nan
1,0,1,2019-10-15,clear-night,nan
2531,1139,1392,2019-10-21,clear-day,nan
1497,915,582,2019-04-17,cloudy,nan
1248,582,666,2019-01-13,clear-day,nan
2,0,2,2019-07-06,cloudy,nan
1833,805,1028,2019-10-01,partly-cloudy-day,nan
62,37,25,2019-02-14,cloudy,Valentine's Day
1417,685,732,2019-10-17,partly-cloudy-day,nan
2844,1297,1547,2019-04-16,clear-day,nan
3,1,2,2019-01-02,clear-night,nan
3,1,2,2019-07-15,clear-night,nan
18,7,11,2019-03-04,partly-cloudy-night,nan
306,144,162,2019-08-05,partly-cloudy-day,nan
2108,957,1151,2019-08-30,partly-cloudy-day,nan
1035,474,561,2019-08-02,partly-cloudy-day,nan
592,172,420,2019-03-03,cloudy,nan
2813,1207,1606,2019-10-04,partly-cloudy-day,nan
1,0,1,2019-07-15,clear-night,nan
1366,525,841,2019-12-12,clear-day,nan
3,2,1,2019-05-21,clear-night,nan
1,0,1,2019-06-27,clear-night,nan
780,467,313,2019-02-09,clear-day,nan
2625,1379,1246,2019-12-24,clear-day,Christmas Eve
16,10,6,2019-02-15,partly-cloudy-night,nan
143,138,5,2019-01-11,clear-night,nan
77,71,6,2019-10-28,partly-cloudy-night,nan
2365,1086,1279,2019-12-08,clear-day,nan
1077,486,591,2019-01-07,partly-cloudy-day,nan
0,0,0,2019-01-28,clear-night,nan
10,5,5,2019-08-11,clear-night,nan
0,0,0,2019-11-30,clear-night,nan
0,0,0,2019-10-20,partly-cloudy-night,nan
820,419,401,2019-01-15,clear-day,nan
9,6,3,2019-05-20,rain,nan
2910,1231,1679,2019-11-23,clear-day,nan
1324,682,642,2019-09-03,clear-day,nan
0,0,0,2019-08-15,partly-cloudy-night,nan
602,280,322,2019-05-21,partly-cloudy-day,nan
69,43,26,2019-06-21,clear-night,nan
2032,891,1141,2019-04-28,cloudy,nan
45,0,45,2019-10-10,partly-cloudy-night,nan
3635,1494,2141,2019-10-26,clear-day,nan
0,0,0,2019-05-15,partly-cloudy-night,nan
23,11,12,2019-01-17,clear-night,nan
751,440,311,2019-06-18,cloudy,nan
191,98,93,2019-07-09,clear-day,nan
0,0,0,2019-04-28,clear-night,nan
1755,823,932,2019-07-16,clear-day,nan
1993,993,1000,2019-07-19,partly-cloudy-day,nan
33,29,4,2019-03-09,clear-night,nan
87,79,8,2019-01-08,cloudy,nan
417,157,260,2019-05-10,cloudy,nan
1213,544,669,2019-03-25,cloudy,nan
120,42,78,2019-06-16,partly-cloudy-day,Father's Day
0,0,0,2019-09-08,clear-night,nan
1542,779,763,2019-03-14,clear-day,nan
12,6,6,2019-09-08,cloudy,nan
10,8,2,2019-08-31,partly-cloudy-night,nan
3197,1738,1459,2019-12-25,clear-day,Christmas Day
0,0,0,2019-10-10,cloudy,nan
1998,970,1028,2019-08-12,partly-cloudy-day,nan
80,54,26,2019-12-14,rain,nan
2,0,2,2019-06-06,cloudy,nan
171,78,93,2019-01-03,partly-cloudy-night,nan
679,336,343,2019-08-06,partly-cloudy-day,nan
906,487,419,2019-03-26,clear-day,nan
2,0,2,2019-10-23,rain,nan
138,57,81,2019-06-01,clear-day,nan
47,30,17,2019-01-05,cloudy,nan
222,109,113,2019-01-27,partly-cloudy-day,nan
0,0,0,2019-10-16,clear-night,nan
2006,859,1147,2019-05-04,partly-cloudy-day,nan
52,24,28,2019-03-19,clear-night,nan
453,253,200,2019-01-17,partly-cloudy-night,nan
338,206,132,2019-12-30,cloudy,nan
2112,969,1143,2019-06-30,partly-cloudy-day,nan
2844,1208,1636,2019-09-28,partly-cloudy-day,nan
3,2,1,2019-10-15,clear-night,nan
75,64,11,2019-12-26,cloudy,nan
867,531,336,2019-05-29,partly-cloudy-day,nan
2985,1291,1694,2019-04-19,partly-cloudy-day,nan
1455,733,722,2019-05-15,partly-cloudy-day,nan
0,0,0,2019-01-08,cloudy,nan
70,68,2,2019-11-17,cloudy,nan
166,76,90,2019-04-12,cloudy,nan
71,33,38,2019-05-26,clear-night,Memorial Day
97,78,19,2019-01-06,partly-cloudy-night,nan
0,0,0,2019-05-06,cloudy,nan
47,42,5,2019-02-21,clear-night,nan
1369,741,628,2019-08-13,partly-cloudy-day,nan
127,115,12,2019-08-28,rain,nan
2013,1005,1008,2019-07-28,partly-cloudy-day,nan
1,0,1,2019-04-26,cloudy,nan
1,0,1,2019-03-17,clear-night,St. Patrick's Day
2190,968,1222,2019-11-04,clear-day,nan
0,0,0,2019-11-15,clear-night,nan
0,0,0,2019-06-17,cloudy,nan
1291,686,605,2019-07-21,partly-cloudy-day,nan
2961,1377,1584,2019-05-27,clear-day,Memorial Day
213,127,86,2019-07-07,cloudy,nan
28,22,6,2019-07-31,partly-cloudy-night,nan
1742,793,949,2019-08-07,partly-cloudy-day,nan
1333,603,730,2019-03-05,clear-day,nan
2,1,1,2019-07-16,clear-night,nan
1951,874,1077,2019-10-24,clear-day,nan
2361,1036,1325,2019-03-30,clear-day,nan
294,166,128,2019-10-03,rain,nan
417,224,193,2019-06-10,cloudy,nan
255,158,97,2019-01-31,clear-day,nan
1837,809,1028,2019-05-19,partly-cloudy-day,nan
449,248,201,2019-01-18,cloudy,nan
3433,1503,1930,2019-05-11,clear-day,nan
1560,891,669,2019-10-24,clear-day,nan
360,206,154,2019-07-23,cloudy,nan
0,0,0,2019-02-02,partly-cloudy-night,nan
45,43,2,2019-10-24,clear-night,nan
2418,1140,1278,2019-08-01,partly-cloudy-day,nan
448,156,292,2019-05-21,partly-cloudy-day,nan
1882,836,1046,2019-05-16,partly-cloudy-day,nan
51,43,8,2019-07-20,clear-night,nan
33,0,33,2019-12-03,clear-night,nan
0,0,0,2019-12-30,rain,nan
47,44,3,2019-10-06,cloudy,nan
0,0,0,2019-02-02,clear-day,nan
881,548,333,2019-08-18,partly-cloudy-day,nan
21,14,7,2019-07-27,clear-night,nan
2269,1039,1230,2019-06-02,partly-cloudy-day,nan
1969,949,1020,2019-11-28,cloudy,Thanksgiving Day
0,0,0,2019-12-26,clear-night,nan
198,117,81,2019-04-16,clear-night,nan
2135,999,1136,2019-07-08,partly-cloudy-day,nan
1727,725,1002,2019-04-11,partly-cloudy-day,nan
2005,975,1030,2019-06-07,clear-day,nan
282,129,153,2019-10-11,clear-night,nan
5,3,2,2019-01-01,partly-cloudy-night,New Year's Day
881,441,440,2019-02-11,partly-cloudy-day,nan
0,0,0,2019-07-24,partly-cloudy-night,nan
13,11,2,2019-03-06,clear-night,nan
150,70,80,2019-05-03,cloudy,nan
187,82,105,2019-12-10,partly-cloudy-night,nan
777,391,386,2019-03-31,cloudy,nan
78,45,33,2019-04-05,clear-night,nan
2449,1233,1216,2019-07-05,partly-cloudy-day,nan
337,163,174,2019-08-22,partly-cloudy-day,nan
429,156,273,2019-10-02,partly-cloudy-day,nan
2282,1039,1243,2019-11-26,clear-day,nan
1334,582,752,2019-06-27,partly-cloudy-day,nan
33,20,13,2019-12-05,cloudy,nan
1224,716,508,2019-09-04,partly-cloudy-day,nan
2354,1016,1338,2019-09-22,partly-cloudy-day,nan
1311,744,567,2019-04-10,clear-day,nan
1622,722,900,2019-05-09,cloudy,nan
1547,788,759,2019-07-17,partly-cloudy-day,nan
269,161,108,2019-11-02,clear-night,nan
42,0,42,2019-04-12,rain,nan
2177,1010,1167,2019-05-03,cloudy,nan
3346,1775,1571,2019-12-31,cloudy,New Year's Eve
1105,572,533,2019-03-25,cloudy,nan
185,85,100,2019-06-24,clear-day,nan
74,53,21,2019-08-31,partly-cloudy-night,nan
45,43,2,2019-11-06,clear-night,nan
233,107,126,2019-01-01,partly-cloudy-day,New Year's Day
1632,649,983,2019-03-19,partly-cloudy-day,nan
89,0,89,2019-11-16,clear-night,nan
1,0,1,2019-01-04,clear-night,nan
2244,1148,1096,2019-09-29,partly-cloudy-day,nan
2253,1133,1120,2019-12-07,clear-day,nan
4,0,4,2019-02-12,rain,nan
1563,716,847,2019-09-06,cloudy,nan
0,0,0,2019-05-04,cloudy,nan
1921,1015,906,2019-09-18,partly-cloudy-day,nan
592,342,250,2019-12-21,partly-cloudy-day,nan
0,0,0,2019-03-04,sleet,nan
340,133,207,2019-03-12,partly-cloudy-day,nan
2740,1161,1579,2019-06-15,partly-cloudy-day,nan
5,4,1,2019-08-10,clear-night,nan
1477,708,769,2019-03-28,clear-day,nan
79,78,1,2019-12-10,cloudy,nan
582,249,333,2019-05-13,cloudy,nan
384,132,252,2019-04-10,clear-day,nan
0,0,0,2019-04-14,partly-cloudy-night,nan
309,133,176,2019-10-30,cloudy,nan
1667,853,814,2019-12-20,clear-day,nan
206,101,105,2019-07-22,partly-cloudy-day,nan
10,2,8,2019-06-03,clear-night,nan
3,2,1,2019-04-27,cloudy,nan
826,383,443,2019-07-11,rain,nan
200,117,83,2019-01-24,rain,nan
103,56,47,2019-06-24,partly-cloudy-night,nan
2222,1110,1112,2019-12-15,clear-day,nan
2435,1164,1271,2019-05-19,partly-cloudy-day,nan
6,1,5,2019-11-24,rain,nan
2150,1214,936,2019-09-20,clear-day,nan
2555,1155,1400,2019-07-13,clear-day,nan
3514,1653,1861,2019-04-27,partly-cloudy-day,nan
1292,631,661,2019-12-11,partly-cloudy-day,nan
1,1,0,2019-01-13,cloudy,nan
8,4,4,2019-01-05,clear-night,nan
0,0,0,2019-08-04,clear-night,nan
928,467,461,2019-01-03,partly-cloudy-day,nan
1,0,1,2019-02-08,rain,nan
226,179,47,2019-01-16,partly-cloudy-night,nan
32,26,6,2019-09-25,clear-night,nan
0,0,0,2019-08-04,partly-cloudy-night,nan
135,68,67,2019-06-28,partly-cloudy-night,nan
326,143,183,2019-08-14,partly-cloudy-day,nan
3528,1387,2141,2019-10-13,partly-cloudy-day,nan
114,74,40,2019-10-27,rain,nan
318,183,135,2019-10-30,cloudy,nan
31,28,3,2019-01-10,partly-cloudy-night,nan
1536,656,880,2019-09-24,partly-cloudy-day,nan
18,11,7,2019-01-11,clear-night,nan
1201,564,637,2019-07-26,partly-cloudy-day,nan
1842,743,1099,2019-08-19,partly-cloudy-day,nan
366,143,223,2019-05-02,cloudy,nan
31,29,2,2019-06-30,clear-night,nan
7,0,7,2019-04-10,clear-night,nan
3,2,1,2019-03-27,clear-night,nan
0,0,0,2019-09-28,clear-night,nan
2513,1115,1398,2019-09-15,partly-cloudy-day,nan
12,5,7,2019-06-23,clear-night,nan
3083,1154,1929,2019-05-26,partly-cloudy-day,nan
851,468,383,2019-11-07,cloudy,nan
6,0,6,2019-01-19,clear-night,nan
26,24,2,2019-06-23,clear-night,nan
2266,988,1278,2019-06-11,clear-day,nan
1248,594,654,2019-12-16,cloudy,nan
0,0,0,2019-09-20,clear-night,nan
1378,661,717,2019-06-25,cloudy,nan
9,5,4,2019-01-22,clear-night,nan
3,0,3,2019-06-10,partly-cloudy-night,nan
0,0,0,2019-12-21,partly-cloudy-night,nan
464,291,173,2019-04-21,partly-cloudy-day,Easter Sunday
587,296,291,2019-05-30,cloudy,nan
49,42,7,2019-05-23,clear-night,nan
73,70,3,2019-09-12,rain,nan
0,0,0,2019-03-16,clear-night,nan
0,0,0,2019-08-26,partly-cloudy-night,nan
294,128,166,2019-07-11,clear-day,nan
518,228,290,2019-11-18,cloudy,nan
25,19,6,2019-08-29,clear-night,nan
190,93,97,2019-07-18,cloudy,nan
989,475,514,2019-01-09,partly-cloudy-day,nan
52,51,1,2019-12-08,clear-night,nan
400,182,218,2019-12-27,cloudy,nan
1,0,1,2019-10-01,cloudy,nan
2191,956,1235,2019-09-08,partly-cloudy-day,nan
10,7,3,2019-12-26,cloudy,nan
1,0,1,2019-05-17,partly-cloudy-night,nan
52,47,5,2019-01-28,clear-night,nan
99,65,34,2019-07-18,cloudy,nan
1,0,1,2019-06-29,clear-night,nan
34,18,16,2019-09-09,partly-cloudy-night,nan
55,49,6,2019-05-30,cloudy,nan
2241,983,1258,2019-11-01,clear-day,nan
2,2,0,2019-12-12,clear-night,nan
17,16,1,2019-02-23,cloudy,nan
80,49,31,2019-08-01,partly-cloudy-night,nan
1219,579,640,2019-11-29,clear-day,Black Friday
3395,1539,1856,2019-04-13,partly-cloudy-day,nan
7,3,4,2019-07-30,clear-night,nan
5,4,1,2019-09-01,partly-cloudy-night,nan
2,2,0,2019-03-02,cloudy,nan
320,169,151,2019-10-21,clear-night,nan
73,72,1,2019-11-19,partly-cloudy-night,nan
282,119,163,2019-07-29,clear-day,nan
1044,480,564,2019-02-08,clear-day,nan
7,5,2,2019-05-12,rain,Mother's Day
26,24,2,2019-12-17,cloudy,nan
2,1,1,2019-04-08,cloudy,nan
909,484,425,2019-02-24,cloudy,nan
577,332,245,2019-08-14,partly-cloudy-day,nan
115,60,55,2019-11-05,partly-cloudy-night,nan
466,169,297,2019-06-12,clear-day,nan
1283,509,774,2019-04-02,partly-cloudy-day,nan
1550,812,738,2019-07-02,partly-cloudy-day,nan
350,117,233,2019-04-18,cloudy,nan
2663,1392,1271,2019-07-06,partly-cloudy-day,nan
1,0,1,2019-03-28,clear-night,nan
16,15,1,2019-11-05,clear-night,nan
0,0,0,2019-09-25,clear-night,nan
4,3,1,2019-05-28,clear-night,nan
0,0,0,2019-03-13,clear-night,nan
1564,829,735,2019-08-26,partly-cloudy-day,nan
2452,1062,1390,2019-09-29,partly-cloudy-day,nan
773,773,0,2019-02-19,clear-day,nan
18,14,4,2019-02-14,clear-night,Valentine's Day
55,39,16,2019-06-03,clear-night,nan
0,0,0,2019-10-26,clear-night,nan
11,7,4,2019-01-20,partly-cloudy-night,nan
903,470,433,2019-04-09,partly-cloudy-day,nan
1931,759,1172,2019-09-19,clear-day,nan
0,0,0,2019-04-01,clear-night,nan
30,19,11,2019-08-20,clear-night,nan
1,0,1,2019-08-21,clear-night,nan
1748,715,1033,2019-09-10,cloudy,nan
12,11,1,2019-12-16,rain,nan
2051,849,1202,2019-11-25,clear-day,nan
3,3,0,2019-06-08,clear-night,nan
642,279,363,2019-04-22,rain,Easter Monday
0,0,0,2019-04-01,clear-night,nan
493,204,289,2019-02-20,snow,nan
1171,526,645,2019-12-04,partly-cloudy-day,nan
1113,577,536,2019-10-02,clear-day,nan
10,0,10,2019-03-08,partly-cloudy-night,nan
10,6,4,2019-02-01,partly-cloudy-night,nan
1944,989,955,2019-07-03,cloudy,nan
432,171,261,2019-09-30,partly-cloudy-day,nan
0,0,0,2019-01-12,partly-cloudy-day,nan
820,495,325,2019-10-20,partly-cloudy-day,nan
1659,753,906,2019-09-18,partly-cloudy-day,nan
375,157,218,2019-07-31,clear-day,nan
1753,815,938,2019-05-20,partly-cloudy-day,nan
25,11,14,2019-01-16,partly-cloudy-night,nan
1064,590,474,2019-09-02,rain,Labor Day
806,494,312,2019-06-16,partly-cloudy-day,Father's Day
0,0,0,2019-03-05,cloudy,nan
89,68,21,2019-09-14,cloudy,nan
0,0,0,2019-08-28,partly-cloudy-night,nan
856,444,412,2019-08-03,partly-cloudy-day,nan
260,132,128,2019-11-10,partly-cloudy-night,nan
9,5,4,2019-11-27,cloudy,nan
691,343,348,2019-02-07,cloudy,nan
19,10,9,2019-03-11,clear-night,nan
30,29,1,2019-05-01,cloudy,nan
351,164,187,2019-03-30,partly-cloudy-day,nan
162,72,90,2019-11-10,partly-cloudy-day,nan
235,106,129,2019-08-02,partly-cloudy-day,nan
1,0,1,2019-08-06,partly-cloudy-night,nan
182,63,119,2019-03-29,cloudy,nan
964,501,463,2019-06-19,cloudy,nan
0,0,0,2019-09-24,partly-cloudy-night,nan
1483,811,672,2019-02-04,clear-day,nan
16,11,5,2019-08-21,clear-night,nan
125,73,52,2019-07-05,cloudy,nan
578,273,305,2019-01-29,cloudy,nan
1738,999,739,2019-10-01,clear-day,nan
127,64,63,2019-12-30,rain,nan
70,61,9,2019-08-18,partly-cloudy-night,nan
27,0,27,2019-04-03,clear-night,nan
321,157,164,2019-01-15,clear-day,nan
7,5,2,2019-03-20,clear-night,nan
3371,1470,1901,2019-04-06,clear-day,nan
22,19,3,2019-03-26,clear-night,nan
996,441,555,2019-02-24,cloudy,nan
59,20,39,2019-06-01,partly-cloudy-night,nan
692,392,300,2019-12-11,cloudy,nan
500,229,271,2019-11-12,cloudy,nan
536,316,220,2019-08-25,partly-cloudy-day,nan
2273,1013,1260,2019-08-02,partly-cloudy-day,nan
1649,746,903,2019-11-15,clear-day,nan
2135,1163,972,2019-04-07,clear-day,nan
1,0,1,2019-04-25,clear-night,nan
7,5,2,2019-01-23,partly-cloudy-night,nan
817,515,302,2019-06-20,rain,nan
16,6,10,2019-04-14,cloudy,Tax Day
1,0,1,2019-03-02,snow,nan
1565,649,916,2019-09-26,partly-cloudy-day,nan
1663,718,945,2019-11-05,partly-cloudy-day,nan
968,612,356,2019-07-10,partly-cloudy-day,nan
249,120,129,2019-10-14,cloudy,Columbus Day (regional holiday)
12,0,12,2019-10-23,rain,nan
2178,1060,1118,2019-08-05,partly-cloudy-day,nan
9,4,5,2019-03-02,snow,nan
0,0,0,2019-11-22,cloudy,nan
26,17,9,2019-07-22,rain,nan
2120,909,1211,2019-05-02,partly-cloudy-day,nan
0,0,0,2019-07-02,partly-cloudy-night,nan
35,12,23,2019-04-20,rain,nan
1809,929,880,2019-06-06,partly-cloudy-day,nan
75,75,0,2019-12-21,clear-night,nan
2,1,1,2019-03-25,cloudy,nan
1425,837,588,2019-06-29,partly-cloudy-day,nan
127,82,45,2019-09-27,clear-night,nan
1282,685,597,2019-08-05,partly-cloudy-day,nan
2188,1066,1122,2019-08-26,partly-cloudy-day,nan
0,0,0,2019-05-29,partly-cloudy-night,nan
242,100,142,2019-09-28,partly-cloudy-night,nan
304,127,177,2019-07-25,partly-cloudy-day,nan
297,126,171,2019-10-25,clear-night,nan
1662,803,859,2019-06-17,partly-cloudy-day,nan
425,232,193,2019-08-11,clear-day,nan
59,0,59,2019-10-26,partly-cloudy-night,nan
396,170,226,2019-04-26,cloudy,nan
180,60,120,2019-01-23,partly-cloudy-day,nan
0,0,0,2019-03-26,clear-night,nan
1898,1047,851,2019-07-12,partly-cloudy-day,nan
11,11,0,2019-12-29,rain,nan
119,70,49,2019-09-16,cloudy,nan
1004,588,416,2019-01-04,clear-day,nan
987,483,504,2019-02-13,rain,nan
387,200,187,2019-09-02,partly-cloudy-day,Labor Day
1,0,1,2019-01-30,clear-night,nan
313,154,159,2019-08-09,clear-day,nan
2117,916,1201,2019-10-23,partly-cloudy-day,nan
2,2,0,2019-01-09,partly-cloudy-night,nan
363,207,156,2019-02-18,cloudy,Presidents' Day (regional holiday)
1269,582,687,2019-05-23,partly-cloudy-day,nan
81,50,31,2019-03-09,partly-cloudy-night,nan
7,0,7,2019-04-11,cloudy,nan
178,99,79,2019-02-03,clear-day,nan
0,0,0,2019-01-12,cloudy,nan
2176,1052,1124,2019-02-16,clear-day,nan
288,165,123,2019-06-16,partly-cloudy-day,Father's Day
376,193,183,2019-03-21,rain,nan
1099,534,565,2019-03-25,cloudy,nan
45,31,14,2019-03-31,partly-cloudy-night,nan
250,111,139,2019-10-07,cloudy,nan
1401,796,605,2019-05-21,clear-day,nan
1591,872,719,2019-06-02,partly-cloudy-day,nan
1159,482,677,2019-10-16,cloudy,nan
0,0,0,2019-05-03,cloudy,nan
2423,1306,1117,2019-03-30,partly-cloudy-day,nan
0,0,0,2019-08-05,clear-night,nan
951,481,470,2019-04-03,clear-day,nan
153,61,92,2019-06-21,partly-cloudy-night,nan
0,0,0,2019-04-05,clear-night,nan
0,0,0,2019-02-17,clear-night,nan
1849,1012,837,2019-12-14,cloudy,nan
126,62,64,2019-01-07,clear-night,nan
1433,738,695,2019-07-30,clear-day,nan
95,61,34,2019-09-01,partly-cloudy-night,Labor Day
5,4,1,2019-04-09,cloudy,nan
170,73,97,2019-07-23,rain,nan
2289,1004,1285,2019-10-21,clear-day,nan
884,454,430,2019-01-13,partly-cloudy-day,nan
0,0,0,2019-12-05,partly-cloudy-night,nan
0,0,0,2019-11-28,cloudy,Thanksgiving Day
83,32,51,2019-06-18,rain,nan
2778,1296,1482,2019-10-28,cloudy,nan
0,0,0,2019-02-26,clear-night,nan
1070,460,610,2019-02-11,cloudy,nan
186,105,81,2019-04-06,cloudy,nan
16,11,5,2019-01-26,partly-cloudy-night,nan
1899,880,1019,2019-11-15,clear-day,nan
48,39,9,2019-08-12,clear-night,nan
8,6,2,2019-10-23,rain,nan
124,55,69,2019-03-10,rain,Daylight Saving Time starts
1864,850,1014,2019-03-29,partly-cloudy-day,nan
1293,560,733,2019-07-20,partly-cloudy-day,nan
0,0,0,2019-11-11,clear-night,Veterans Day
121,42,79,2019-02-01,clear-day,nan
2661,1210,1451,2019-08-25,partly-cloudy-day,nan
87,71,16,2019-07-24,partly-cloudy-night,nan
276,113,163,2019-09-10,cloudy,nan
12,8,4,2019-12-27,clear-night,nan
12,0,12,2019-12-13,rain,nan
2,0,2,2019-03-05,nan,nan
14,0,14,2019-03-15,rain,nan
27,25,2,2019-04-06,clear-night,nan
2235,1068,1167,2019-07-28,partly-cloudy-day,nan
10,6,4,2019-04-15,partly-cloudy-night,nan
1515,798,717,2019-07-19,partly-cloudy-day,nan
2878,1259,1619,2019-09-21,clear-day,nan
423,276,147,2019-04-22,cloudy,Easter Monday
1785,863,922,2019-01-19,cloudy,nan
2,0,2,2019-12-09,cloudy,nan
1,0,1,2019-11-06,partly-cloudy-night,nan
2348,1054,1294,2019-08-27,partly-cloudy-day,nan
1,0,1,2019-01-14,partly-cloudy-night,nan
1,0,1,2019-11-29,clear-night,nan
7,5,2,2019-12-03,cloudy,nan
635,327,308,2019-06-04,clear-day,nan
10,9,1,2019-03-13,partly-cloudy-night,nan
243,145,98,2019-02-23,clear-day,nan
0,0,0,2019-10-24,clear-night,nan
163,72,91,2019-06-17,partly-cloudy-day,nan
247,124,123,2019-03-07,partly-cloudy-night,nan
2424,1204,1220,2019-03-23,clear-day,nan
717,427,290,2019-06-21,rain,nan
2173,1098,1075,2019-08-02,partly-cloudy-day,nan
425,239,186,2019-07-06,partly-cloudy-day,nan
581,307,274,2019-09-16,cloudy,nan
270,118,152,2019-07-03,partly-cloudy-day,nan
308,178,130,2019-10-20,partly-cloudy-day,nan
247,101,146,2019-07-15,clear-day,nan
1246,700,546,2019-11-03,clear-day,Daylight Saving Time ends
29,25,4,2019-10-17,cloudy,nan
3,2,1,2019-12-01,rain,nan
653,326,327,2019-04-10,partly-cloudy-day,nan
6,4,2,2019-07-16,clear-night,nan
205,103,102,2019-06-10,cloudy,nan
1774,767,1007,2019-07-14,partly-cloudy-day,nan
0,0,0,2019-03-11,partly-cloudy-night,nan
1992,1089,903,2019-06-07,partly-cloudy-day,nan
208,111,97,2019-05-27,clear-day,Memorial Day
682,285,397,2019-08-22,partly-cloudy-day,nan
2,0,2,2019-11-15,partly-cloudy-night,nan
71,34,37,2019-11-20,cloudy,nan
612,257,355,2019-03-31,partly-cloudy-day,nan
1124,715,409,2019-07-02,clear-day,nan
219,134,85,2019-09-06,cloudy,nan
3007,1268,1739,2019-04-16,clear-day,nan
7,0,7,2019-04-04,clear-night,nan
3256,1632,1624,2019-10-19,clear-day,nan
2311,1058,1253,2019-05-15,partly-cloudy-day,nan
869,733,136,2019-09-08,partly-cloudy-day,nan
26,0,26,2019-11-24,partly-cloudy-night,nan
54,52,2,2019-10-06,cloudy,nan
2,1,1,2019-05-18,clear-night,nan
1814,837,977,2019-07-01,clear-day,nan
12,3,9,2019-01-19,partly-cloudy-night,nan
1,0,1,2019-12-20,partly-cloudy-night,nan
2096,895,1201,2019-06-16,partly-cloudy-day,Father's Day
2132,906,1226,2019-10-25,partly-cloudy-day,nan
282,126,156,2019-09-26,clear-day,nan
51,40,11,2019-10-12,cloudy,nan
1525,795,730,2019-06-12,partly-cloudy-day,nan
2133,946,1187,2019-08-30,clear-day,nan
254,149,105,2019-12-08,clear-day,nan
1060,527,533,2019-02-04,clear-day,nan
1,1,0,2019-12-07,clear-night,nan
1468,677,791,2019-10-10,partly-cloudy-day,nan
2,1,1,2019-01-18,cloudy,nan
850,452,398,2019-07-20,clear-day,nan
2532,1242,1290,2019-01-02,partly-cloudy-day,nan
110,53,57,2019-02-10,clear-night,nan
95,22,73,2019-05-05,rain,Cinco de Mayo
1,0,1,2019-06-11,cloudy,nan
76,74,2,2019-11-09,partly-cloudy-night,nan
274,126,148,2019-04-24,clear-day,nan
188,87,101,2019-06-27,clear-day,nan
1601,775,826,2019-02-09,clear-day,nan
1089,489,600,2019-02-15,cloudy,nan
2037,992,1045,2019-07-28,clear-day,nan
1440,639,801,2019-06-05,clear-day,nan
3,0,3,2019-01-08,partly-cloudy-night,nan
45,41,4,2019-02-04,clear-night,nan
6,5,1,2019-01-11,clear-night,nan
174,90,84,2019-07-20,clear-day,nan
224,106,118,2019-10-29,cloudy,nan
1278,621,657,2019-04-18,partly-cloudy-day,nan
77,43,34,2019-12-31,partly-cloudy-night,New Year's Eve
1508,632,876,2019-11-19,cloudy,nan
0,0,0,2019-10-26,partly-cloudy-night,nan
1831,875,956,2019-08-08,partly-cloudy-day,nan
1,0,1,2019-01-07,clear-night,nan
1,0,1,2019-02-21,cloudy,nan
5,0,5,2019-05-31,rain,nan
1645,908,737,2019-10-01,cloudy,nan
0,0,0,2019-04-04,clear-night,nan
60,55,5,2019-10-26,partly-cloudy-night,nan
1584,724,860,2019-12-12,clear-day,nan
1320,640,680,2019-11-25,clear-day,nan
32,17,15,2019-01-02,clear-night,nan
183,84,99,2019-12-17,rain,nan
642,397,245,2019-11-16,clear-day,nan
1678,850,828,2019-07-11,partly-cloudy-day,nan
1,0,1,2019-06-12,clear-night,nan
1975,919,1056,2019-09-13,partly-cloudy-day,nan
600,289,311,2019-03-06,clear-day,nan
1088,554,534,2019-08-20,clear-day,nan
965,386,579,2019-10-16,cloudy,nan
1864,984,880,2019-06-11,clear-day,nan
1,1,0,2019-09-06,partly-cloudy-night,nan
0,0,0,2019-09-23,clear-night,nan
1594,841,753,2019-10-30,cloudy,nan
2,1,1,2019-02-28,cloudy,nan
3,2,1,2019-01-03,cloudy,nan
5,2,3,2019-08-07,partly-cloudy-night,nan
1929,956,973,2019-11-23,clear-day,nan
2438,1054,1384,2019-03-09,clear-day,nan
198,130,68,2019-10-29,rain,nan
2,1,1,2019-06-16,cloudy,Father's Day
0,0,0,2019-02-04,clear-night,nan
70,0,70,2019-05-17,partly-cloudy-night,nan
2005,1007,998,2019-08-19,partly-cloudy-day,nan
1676,654,1022,2019-07-16,clear-day,nan
1,0,1,2019-09-10,partly-cloudy-night,nan
0,0,0,2019-04-16,clear-night,nan
0,0,0,2019-05-10,cloudy,nan
202,100,102,2019-08-15,partly-cloudy-night,nan
1757,723,1034,2019-05-21,partly-cloudy-day,nan
414,213,201,2019-03-08,clear-day,nan
33,0,33,2019-11-09,clear-night,nan
103,39,64,2019-06-09,clear-night,nan
0,0,0,2019-08-12,clear-night,nan
457,268,189,2019-05-25,clear-day,nan
736,317,419,2019-02-27,cloudy,nan
3207,1246,1961,2019-04-19,cloudy,nan
106,50,56,2019-11-18,cloudy,nan
16,9,7,2019-05-03,cloudy,nan
90,0,90,2019-10-20,cloudy,nan
0,0,0,2019-08-29,partly-cloudy-night,nan
1249,434,815,2019-07-31,partly-cloudy-day,nan
43,20,23,2019-01-17,partly-cloudy-night,nan
1055,560,495,2019-12-30,cloudy,nan
1004,501,503,2019-07-08,partly-cloudy-day,nan
54,37,17,2019-09-17,clear-night,nan
1638,813,825,2019-07-21,partly-cloudy-day,nan
2758,1272,1486,2019-05-27,partly-cloudy-day,Memorial Day
966,611,355,2019-11-21,clear-day,nan
0,0,0,2019-03-20,clear-night,nan
127,61,66,2019-04-28,cloudy,nan
5,4,1,2019-09-27,clear-night,nan
3,1,2,2019-04-25,clear-night,nan
1825,858,967,2019-07-19,cloudy,nan
2173,1113,1060,2019-10-24,clear-day,nan
1433,699,734,2019-02-05,clear-day,nan
16,6,10,2019-01-08,cloudy,nan
1319,609,710,2019-03-25,cloudy,nan
12,3,9,2019-02-24,rain,nan
1277,531,746,2019-07-21,partly-cloudy-day,nan
1694,722,972,2019-03-24,partly-cloudy-day,nan
68,54,14,2019-06-07,clear-night,nan
30,19,11,2019-12-30,rain,nan
1,0,1,2019-08-19,partly-cloudy-night,nan
1235,517,718,2019-03-05,clear-day,nan
746,386,360,2019-01-08,cloudy,nan
2,0,2,2019-09-03,partly-cloudy-night,nan
1,0,1,2019-05-20,rain,nan
105,49,56,2019-01-01,partly-cloudy-night,New Year's Day
25,9,16,2019-02-17,cloudy,nan
1980,986,994,2019-03-11,clear-day,nan
1058,500,558,2019-01-18,cloudy,nan
65,62,3,2019-10-05,cloudy,nan
20,12,8,2019-08-17,cloudy,nan
2984,1469,1515,2019-05-11,clear-day,nan
2071,1111,960,2019-08-12,clear-day,nan
2,1,1,2019-02-22,clear-night,nan
0,0,0,2019-02-02,clear-night,nan
2806,2231,575,2019-09-28,partly-cloudy-day,nan
1139,602,537,2019-10-15,clear-day,nan
248,93,155,2019-08-19,partly-cloudy-day,nan
617,384,233,2019-03-27,clear-day,nan
0,0,0,2019-12-24,clear-night,Christmas Eve
0,0,0,2019-02-06,clear-night,nan
580,313,267,2019-08-22,partly-cloudy-day,nan
2,0,2,2019-07-07,partly-cloudy-night,nan
0,0,0,2019-03-15,clear-night,nan
0,0,0,2019-12-13,partly-cloudy-night,nan
3,0,3,2019-10-30,cloudy,nan
201,103,98,2019-07-14,clear-day,nan
0,0,0,2019-01-12,partly-cloudy-day,nan
143,93,50,2019-09-14,cloudy,nan
2013,890,1123,2019-07-01,clear-day,nan
3388,1440,1948,2019-05-26,partly-cloudy-day,nan
9,7,2,2019-12-24,clear-night,Christmas Day
1393,762,631,2019-07-10,partly-cloudy-day,nan
1573,664,909,2019-07-23,cloudy,nan
1912,987,925,2019-10-28,cloudy,nan
86,76,10,2019-07-28,partly-cloudy-night,nan
198,66,132,2019-04-26,cloudy,nan
3,0,3,2019-02-06,clear-night,nan
1760,1006,754,2019-06-03,clear-day,nan
1139,580,559,2019-09-17,clear-day,nan
1722,713,1009,2019-03-03,partly-cloudy-day,nan
0,0,0,2019-10-02,partly-cloudy-night,nan
1935,855,1080,2019-07-11,partly-cloudy-day,nan
1536,685,851,2019-12-20,clear-day,nan
763,317,446,2019-08-07,partly-cloudy-day,nan
23,11,12,2019-08-13,cloudy,nan
6,0,6,2019-07-01,clear-night,nan
1,0,1,2019-08-29,partly-cloudy-night,nan
1552,679,873,2019-05-14,cloudy,nan
598,310,288,2019-01-16,cloudy,nan
3096,1374,1722,2019-07-05,partly-cloudy-day,nan
1,1,0,2019-01-26,clear-night,nan
12,4,8,2019-09-04,clear-night,nan
2410,1134,1276,2019-12-15,partly-cloudy-day,nan
138,84,54,2019-09-23,clear-night,nan
1754,871,883,2019-05-08,partly-cloudy-day,nan
2170,890,1280,2019-10-10,partly-cloudy-day,nan
359,160,199,2019-01-31,clear-day,nan
751,422,329,2019-11-28,partly-cloudy-day,Thanksgiving Day
0,0,0,2019-12-26,clear-night,nan
7,2,5,2019-10-03,cloudy,nan
3386,1641,1745,2019-05-25,partly-cloudy-day,nan
1,0,1,2019-07-30,clear-night,nan
96,46,50,2019-05-12,cloudy,nan
53,29,24,2019-01-24,rain,nan
1638,827,811,2019-08-20,partly-cloudy-day,nan
46,27,19,2019-05-18,clear-night,nan
102,66,36,2019-06-15,partly-cloudy-night,Father's Day
3,2,1,2019-12-25,clear-night,nan
125,62,63,2019-06-09,clear-day,nan
5,3,2,2019-05-12,cloudy,Mother's Day
216,82,134,2019-04-20,partly-cloudy-night,Easter Sunday
2929,1315,1614,2019-05-06,partly-cloudy-day,nan
0,0,0,2019-09-25,clear-night,nan
369,163,206,2019-01-13,clear-night,nan
1805,837,968,2019-08-26,partly-cloudy-day,nan
0,0,0,2019-11-02,clear-night,nan
34,33,1,2019-12-22,clear-night,nan
1,0,1,2019-11-18,rain,nan
63,61,2,2019-11-20,partly-cloudy-night,nan
7,2,5,2019-03-01,cloudy,nan
312,119,193,2019-09-30,partly-cloudy-day,nan
1207,613,594,2019-03-19,clear-day,nan
122,116,6,2019-01-09,partly-cloudy-night,nan
1649,735,914,2019-11-06,clear-day,nan
2694,1271,1423,2019-06-22,partly-cloudy-day,nan
2856,1212,1644,2019-04-25,partly-cloudy-day,nan
3310,1341,1969,2019-04-27,partly-cloudy-day,nan
760,359,401,2019-01-14,clear-day,nan
472,260,212,2019-01-05,rain,nan
1264,499,765,2019-06-14,clear-day,nan
63,24,39,2019-06-17,partly-cloudy-night,nan
1,0,1,2019-06-24,clear-night,nan
0,0,0,2019-10-27,clear-night,nan
2677,1163,1514,2019-05-19,clear-day,nan
0,0,0,2019-11-24,rain,nan
2,0,2,2019-10-04,cloudy,nan
10,0,10,2019-01-10,partly-cloudy-night,nan
1,0,1,2019-01-11,partly-cloudy-night,nan
8,6,2,2019-01-01,cloudy,New Year's Day
9,6,3,2019-01-13,cloudy,nan
258,128,130,2019-06-29,partly-cloudy-day,nan
778,400,378,2019-06-12,clear-day,nan
1122,509,613,2019-04-02,partly-cloudy-day,nan
8,6,2,2019-01-06,cloudy,nan
17,9,8,2019-02-08,cloudy,nan
464,284,180,2019-02-03,clear-day,nan
58,34,24,2019-07-10,clear-night,nan
3,2,1,2019-07-19,cloudy,nan
35,33,2,2019-03-24,partly-cloudy-night,nan
2135,920,1215,2019-01-06,partly-cloudy-day,nan
274,154,120,2019-06-18,rain,nan
8,0,8,2019-12-16,rain,nan
763,307,456,2019-08-09,partly-cloudy-night,nan
3180,1642,1538,2019-12-27,cloudy,nan
37,35,2,2019-02-26,clear-night,nan
56,36,20,2019-02-24,cloudy,nan
4,0,4,2019-09-15,cloudy,nan
72,51,21,2019-08-03,partly-cloudy-night,nan
1,0,1,2019-11-11,clear-night,nan
4,1,3,2019-01-15,clear-night,nan
152,79,73,2019-07-01,clear-day,nan
10,0,10,2019-12-22,clear-night,nan
2060,907,1153,2019-03-17,clear-day,St. Patrick's Day
82,41,41,2019-03-04,cloudy,nan
0,0,0,2019-07-18,rain,nan
0,0,0,2019-08-14,partly-cloudy-night,nan
2,0,2,2019-03-11,partly-cloudy-night,nan
0,0,0,2019-08-01,partly-cloudy-night,nan
84,44,40,2019-10-27,rain,nan
0,0,0,2019-12-08,partly-cloudy-night,nan
2867,1317,1550,2019-07-27,partly-cloudy-day,nan
130,80,50,2019-09-20,clear-night,nan
44,23,21,2019-04-08,cloudy,nan
531,218,313,2019-05-29,partly-cloudy-day,nan
19,6,13,2019-08-26,partly-cloudy-night,nan
40,33,7,2019-07-23,cloudy,nan
1,0,1,2019-04-02,clear-night,nan
611,330,281,2019-06-28,partly-cloudy-day,nan
1465,688,777,2019-05-20,clear-day,nan
950,386,564,2019-09-12,cloudy,nan
0,0,0,2019-12-31,cloudy,New Year's Eve
1589,711,878,2019-06-28,partly-cloudy-day,nan
1158,601,557,2019-12-20,clear-day,nan
1227,528,699,2019-05-17,cloudy,nan
51,50,1,2019-12-15,clear-night,nan
138,57,81,2019-05-29,partly-cloudy-day,nan
3216,1407,1809,2019-09-07,partly-cloudy-day,nan
512,297,215,2019-06-25,cloudy,nan
1,0,1,2019-01-22,clear-night,nan
0,0,0,2019-01-12,clear-night,nan
1514,814,700,2019-08-09,clear-day,nan
33,17,16,2019-07-12,clear-night,nan
18,10,8,2019-01-15,clear-night,nan
193,97,96,2019-01-04,clear-night,nan
1825,809,1016,2019-02-03,clear-day,nan
0,0,0,2019-12-01,clear-night,nan
2482,1056,1426,2019-09-29,clear-day,nan
345,151,194,2019-05-13,cloudy,nan
2439,1200,1239,2019-06-08,clear-day,nan
533,287,246,2019-09-28,partly-cloudy-day,nan
2086,1016,1070,2019-12-21,clear-day,nan
1772,845,927,2019-06-11,partly-cloudy-day,nan
1,1,0,2019-01-09,partly-cloudy-night,nan
1775,920,855,2019-07-04,partly-cloudy-day,Independence Day
1354,724,630,2019-07-06,partly-cloudy-day,nan
33,13,20,2019-07-27,clear-night,nan
16,11,5,2019-06-16,cloudy,nan
314,120,194,2019-12-10,partly-cloudy-day,nan
2019,905,1114,2019-10-08,partly-cloudy-day,nan
2131,1015,1116,2019-12-23,clear-day,nan
1995,989,1006,2019-08-01,partly-cloudy-day,nan
1657,886,771,2019-04-25,clear-day,nan
61,59,2,2019-10-04,clear-night,nan
1,1,0,2019-01-19,clear-night,nan
79,51,28,2019-06-23,clear-night,nan
1147,486,661,2019-10-21,clear-day,nan
985,534,451,2019-02-25,partly-cloudy-day,nan
1295,568,727,2019-03-12,clear-day,nan
3,1,2,2019-07-29,clear-night,nan
0,0,0,2019-06-20,cloudy,nan
1,0,1,2019-09-01,partly-cloudy-night,nan
1659,850,809,2019-06-17,cloudy,nan
27,0,27,2019-12-17,cloudy,nan
90,63,27,2019-03-28,clear-night,nan
1001,442,559,2019-06-04,partly-cloudy-day,nan
0,0,0,2019-04-18,partly-cloudy-night,nan
108,66,42,2019-10-01,cloudy,nan
2173,967,1206,2019-08-14,partly-cloudy-day,nan
2706,1169,1537,2019-08-16,cloudy,nan
730,360,370,2019-06-10,cloudy,nan
1,0,1,2019-03-07,clear-night,nan
1100,541,559,2019-10-07,cloudy,nan
3307,1367,1940,2019-04-23,clear-day,nan
243,0,243,2019-02-18,clear-night,Presidents' Day (regional holiday)
298,145,153,2019-02-07,cloudy,nan
78,26,52,2019-01-20,partly-cloudy-night,nan
49,33,16,2019-05-25,partly-cloudy-night,nan
168,78,90,2019-02-28,clear-night,nan
525,217,308,2019-10-02,partly-cloudy-day,nan
318,151,167,2019-08-20,partly-cloudy-night,nan
11,9,2,2019-08-28,cloudy,nan
43,0,43,2019-02-01,clear-night,nan
1763,931,832,2019-04-11,partly-cloudy-day,nan
52,50,2,2019-12-16,cloudy,nan
435,227,208,2019-12-02,cloudy,nan
7,7,0,2019-12-21,clear-night,nan
513,267,246,2019-11-08,partly-cloudy-day,nan
1,0,1,2019-02-14,cloudy,Valentine's Day
2538,1368,1170,2019-08-15,partly-cloudy-day,nan
2111,911,1200,2019-03-16,partly-cloudy-day,nan
854,413,441,2019-01-28,clear-day,nan
506,269,237,2019-10-08,cloudy,nan
1221,533,688,2019-04-09,cloudy,nan
7,0,7,2019-10-31,rain,Halloween
3,2,1,2019-09-19,clear-night,nan
2121,1237,884,2019-08-11,partly-cloudy-day,nan
1615,848,767,2019-09-18,partly-cloudy-day,nan
0,0,0,2019-02-13,rain,nan
4,1,3,2019-10-09,cloudy,nan
930,569,361,2019-05-04,cloudy,nan
1930,896,1034,2019-02-23,partly-cloudy-day,nan
27,17,10,2019-03-13,clear-night,nan
57,0,57,2019-12-11,clear-night,nan
776,344,432,2019-01-17,partly-cloudy-day,nan
107,107,0,2019-02-19,clear-night,nan
773,431,342,2019-05-02,partly-cloudy-day,nan
0,0,0,2019-03-29,cloudy,nan
89,67,22,2019-09-23,cloudy,nan
0,0,0,2019-04-11,clear-night,nan
910,511,399,2019-08-21,rain,nan
0,0,0,2019-10-15,clear-night,nan
824,467,357,2019-11-30,clear-day,nan
2408,1160,1248,2019-05-19,partly-cloudy-day,nan
145,58,87,2019-10-31,cloudy,Halloween
645,266,379,2019-09-02,cloudy,Labor Day
1,0,1,2019-04-24,partly-cloudy-night,nan
0,0,0,2019-05-14,cloudy,nan
1131,523,608,2019-05-23,partly-cloudy-day,nan
513,287,226,2019-11-05,cloudy,nan
173,79,94,2019-08-07,cloudy,nan
420,177,243,2019-03-20,clear-day,nan
1041,462,579,2019-07-29,partly-cloudy-day,nan
1353,709,644,2019-07-22,rain,nan
198,99,99,2019-05-07,cloudy,nan
0,0,0,2019-08-13,partly-cloudy-night,nan
1175,534,641,2019-02-04,clear-day,nan
1,0,1,2019-07-05,partly-cloudy-night,nan
9,6,3,2019-11-27,partly-cloudy-night,Thanksgiving Day
0,0,0,2019-06-18,partly-cloudy-night,nan
85,43,42,2019-06-06,partly-cloudy-night,nan
948,427,521,2019-12-11,cloudy,nan
1370,624,746,2019-11-27,cloudy,nan
1869,936,933,2019-04-03,clear-day,nan
22,21,1,2019-02-10,clear-night,nan
1625,1094,531,2019-10-06,cloudy,nan
1246,600,646,2019-01-27,partly-cloudy-day,nan
3194,1624,1570,2019-04-27,partly-cloudy-day,nan
607,341,266,2019-03-03,partly-cloudy-day,nan
979,550,429,2019-06-01,clear-day,nan
303,125,178,2019-08-06,partly-cloudy-day,nan
1,0,1,2019-08-24,partly-cloudy-night,nan
211,89,122,2019-11-22,cloudy,nan
1515,685,830,2019-09-24,partly-cloudy-day,nan
161,95,66,2019-12-27,cloudy,nan
1718,941,777,2019-06-24,partly-cloudy-day,nan
1,0,1,2019-04-20,rain,nan
693,300,393,2019-05-23,partly-cloudy-day,nan
2079,1036,1043,2019-07-24,partly-cloudy-day,nan
381,186,195,2019-10-03,rain,nan
2,1,1,2019-01-23,partly-cloudy-night,nan
627,297,330,2019-09-24,clear-day,nan
340,175,165,2019-02-14,partly-cloudy-day,Valentine's Day
4,2,2,2019-03-27,clear-night,nan
3,0,3,2019-01-30,cloudy,nan
1850,868,982,2019-09-09,partly-cloudy-day,nan
93,44,49,2019-10-16,rain,nan
0,0,0,2019-01-31,clear-night,nan
1754,828,926,2019-04-08,partly-cloudy-day,nan
0,0,0,2019-04-22,clear-night,Easter Monday
1406,710,696,2019-02-18,cloudy,Presidents' Day (regional holiday)
11,4,7,2019-10-31,cloudy,Halloween
1519,672,847,2019-10-17,cloudy,nan
15,12,3,2019-05-07,rain,nan
46,39,7,2019-12-29,cloudy,nan
3,2,1,2019-05-27,clear-night,Memorial Day
2378,1119,1259,2019-08-04,partly-cloudy-day,nan
3,0,3,2019-06-10,clear-night,nan
2389,1082,1307,2019-08-05,clear-day,nan
36,35,1,2019-02-09,clear-night,nan
1,0,1,2019-06-03,partly-cloudy-night,nan
0,0,0,2019-08-09,partly-cloudy-night,nan
670,368,302,2019-09-19,clear-day,nan
0,0,0,2019-03-26,clear-night,nan
2564,1208,1356,2019-08-10,partly-cloudy-day,nan
2,1,1,2019-02-26,clear-night,nan
0,0,0,2019-03-27,clear-night,nan
0,0,0,2019-03-09,partly-cloudy-night,nan
20,13,7,2019-09-20,clear-night,nan
56,42,14,2019-08-01,partly-cloudy-night,nan
19,8,11,2019-01-04,partly-cloudy-night,nan
2679,1307,1372,2019-06-08,clear-day,nan
2584,1209,1375,2019-08-15,partly-cloudy-day,nan
3207,1665,1542,2019-04-21,partly-cloudy-day,Easter Sunday
592,318,274,2019-09-30,partly-cloudy-day,nan
14,12,2,2019-04-26,cloudy,nan
1941,836,1105,2019-11-15,clear-day,nan
0,0,0,2019-02-03,clear-night,nan
0,0,0,2019-11-17,partly-cloudy-night,nan
1274,474,800,2019-08-10,partly-cloudy-night,nan
0,0,0,2019-01-12,partly-cloudy-night,nan
2260,1083,1177,2019-11-10,cloudy,nan
34,17,17,2019-06-29,partly-cloudy-night,nan
18,16,2,2019-02-06,rain,nan
33,32,1,2019-11-22,clear-night,nan
1675,703,972,2019-03-14,clear-day,nan
0,0,0,2019-09-19,clear-night,nan
40,37,3,2019-09-28,partly-cloudy-night,nan
1,0,1,2019-04-17,cloudy,nan
17,15,2,2019-10-22,rain,nan
1375,654,721,2019-02-08,partly-cloudy-day,nan
0,0,0,2019-12-10,cloudy,nan
74,33,41,2019-01-18,cloudy,nan
1441,673,768,2019-02-15,cloudy,nan
381,239,142,2019-03-22,cloudy,nan
658,342,316,2019-01-17,clear-day,nan
103,76,27,2019-10-05,clear-night,nan
2487,1108,1379,2019-09-22,partly-cloudy-day,nan
26,23,3,2019-01-27,clear-night,nan
0,0,0,2019-04-09,partly-cloudy-night,nan
2,0,2,2019-02-04,clear-night,nan
2008,1013,995,2019-08-08,partly-cloudy-day,nan
1,0,1,2019-11-27,clear-night,nan
2100,1255,845,2019-12-28,clear-day,nan
1687,953,734,2019-10-14,cloudy,Columbus Day (regional holiday)
1,0,1,2019-12-29,clear-night,nan
64,24,40,2019-01-31,clear-day,nan
0,0,0,2019-07-25,partly-cloudy-night,nan
0,0,0,2019-05-16,cloudy,nan
19,0,19,2019-01-31,clear-night,nan
1695,742,953,2019-02-21,rain,nan
17,8,9,2019-04-15,rain,Tax Day
0,0,0,2019-10-10,cloudy,nan
591,277,314,2019-04-04,clear-day,nan
2741,1196,1545,2019-10-28,cloudy,nan
0,0,0,2019-02-11,cloudy,nan
2042,1017,1025,2019-09-05,partly-cloudy-day,nan
54,49,5,2019-09-15,clear-night,nan
0,0,0,2019-08-18,cloudy,nan
3379,1514,1865,2019-03-30,clear-day,nan
7,3,4,2019-07-22,partly-cloudy-night,nan
737,372,365,2019-12-19,clear-day,nan
2,0,2,2019-03-31,clear-night,nan
0,0,0,2019-11-11,cloudy,Veterans Day
2332,1100,1232,2019-09-13,partly-cloudy-day,nan
1,0,1,2019-05-21,clear-night,nan
0,0,0,2019-04-28,clear-night,nan
229,85,144,2019-02-26,clear-day,nan
1661,843,818,2019-04-24,clear-day,nan
33,15,18,2019-01-20,rain,nan
864,364,500,2019-08-05,partly-cloudy-day,nan
467,250,217,2019-05-11,partly-cloudy-day,nan
4,0,4,2019-06-22,clear-night,nan
0,0,0,2019-03-18,clear-night,nan
11,9,2,2019-12-03,cloudy,nan
639,350,289,2019-03-24,clear-day,nan
6,4,2,2019-01-14,clear-night,nan
0,0,0,2019-02-17,clear-night,nan
1629,812,817,2019-08-30,partly-cloudy-day,nan
3133,1479,1654,2019-06-15,partly-cloudy-day,nan
0,0,0,2019-12-09,cloudy,nan
2,1,1,2019-05-07,partly-cloudy-night,nan
0,0,0,2019-03-18,clear-night,nan
199,105,94,2019-11-25,clear-day,nan
1449,695,754,2019-02-22,clear-day,nan
3255,1654,1601,2019-05-04,partly-cloudy-day,nan
191,100,91,2019-11-03,clear-day,Daylight Saving Time ends
1,0,1,2019-09-21,clear-night,nan
79,35,44,2019-04-12,cloudy,nan
49,22,27,2019-10-09,partly-cloudy-night,nan
2,0,2,2019-09-12,partly-cloudy-night,nan
31,0,31,2019-12-13,rain,nan
1290,619,671,2019-05-28,cloudy,nan
13,10,3,2019-02-22,clear-night,nan
4,3,1,2019-11-29,clear-night,Black Friday
10,9,1,2019-01-24,cloudy,nan
57,36,21,2019-06-04,clear-night,nan
631,221,410,2019-11-02,partly-cloudy-night,nan
39,0,39,2019-12-18,partly-cloudy-night,nan
4,3,1,2019-02-18,cloudy,Presidents' Day (regional holiday)
0,0,0,2019-01-18,partly-cloudy-night,nan
2895,1320,1575,2019-08-03,partly-cloudy-day,nan
1,0,1,2019-08-25,partly-cloudy-night,nan
707,368,339,2019-05-08,partly-cloudy-day,nan
2362,1214,1148,2019-09-14,cloudy,nan
2063,789,1274,2019-04-27,clear-day,nan
1562,896,666,2019-06-26,clear-day,nan
1,0,1,2019-11-12,clear-night,nan
6,3,3,2019-03-05,clear-night,nan
2097,936,1161,2019-10-11,cloudy,nan
2770,1351,1419,2019-09-21,clear-day,nan
0,0,0,2019-10-29,cloudy,nan
80,78,2,2019-02-05,clear-night,nan
22,10,12,2019-07-19,clear-night,nan
2606,1083,1523,2019-04-29,clear-day,nan
504,240,264,2019-04-19,partly-cloudy-day,nan
1018,532,486,2019-05-01,cloudy,nan
12,7,5,2019-08-30,clear-night,nan
2192,927,1265,2019-07-02,cloudy,nan
141,48,93,2019-05-29,rain,nan
787,386,401,2019-02-27,partly-cloudy-day,nan
55,34,21,2019-05-31,clear-night,nan
0,0,0,2019-05-23,partly-cloudy-night,nan
2707,1295,1412,2019-04-14,partly-cloudy-day,nan
284,171,113,2019-11-09,clear-night,nan
0,0,0,2019-03-06,partly-cloudy-night,nan
0,0,0,2019-07-27,clear-night,nan
0,0,0,2019-08-03,partly-cloudy-night,nan
53,52,1,2019-11-26,clear-night,nan
2,1,1,2019-09-26,clear-night,nan
4,0,4,2019-05-21,clear-night,nan
1,0,1,2019-12-27,cloudy,nan
3,1,2,2019-01-25,clear-night,nan
583,312,271,2019-02-27,cloudy,nan
29,14,15,2019-08-23,partly-cloudy-night,nan
17,0,17,2019-03-07,clear-night,nan
432,217,215,2019-04-05,partly-cloudy-day,nan
2254,1118,1136,2019-06-21,cloudy,nan
5,3,2,2019-06-11,rain,nan
1008,615,393,2019-10-19,clear-day,nan
260,119,141,2019-02-12,snow,nan
3,2,1,2019-12-01,rain,nan
1464,616,848,2019-08-21,partly-cloudy-day,nan
8,4,4,2019-01-23,clear-night,nan
1773,906,867,2019-09-16,cloudy,nan
1,0,1,2019-10-07,cloudy,nan
1930,887,1043,2019-04-13,clear-day,nan
1336,547,789,2019-09-23,clear-day,nan
1,0,1,2019-06-07,clear-night,nan
33,12,21,2019-07-30,clear-night,nan
4,1,3,2019-09-23,partly-cloudy-night,nan
1,0,1,2019-07-23,cloudy,nan
233,127,106,2019-03-24,clear-day,nan
64,60,4,2019-01-27,partly-cloudy-night,nan
0,0,0,2019-12-04,partly-cloudy-night,nan
39,33,6,2019-09-06,cloudy,nan
878,408,470,2019-03-06,partly-cloudy-day,nan
1875,841,1034,2019-09-16,partly-cloudy-day,nan
2575,1312,1263,2019-07-27,clear-day,nan
1079,542,537,2019-11-07,cloudy,nan
987,488,499,2019-02-26,clear-day,nan
2443,1127,1316,2019-07-07,partly-cloudy-day,nan
4,2,2,2019-01-20,rain,nan
2174,1140,1034,2019-09-27,partly-cloudy-day,nan
2257,944,1313,2019-04-18,cloudy,nan
1183,510,673,2019-10-22,cloudy,nan
1495,833,662,2019-05-16,partly-cloudy-day,nan
1008,573,435,2019-06-19,cloudy,nan
1310,624,686,2019-07-06,rain,nan
1263,551,712,2019-11-19,cloudy,nan
5,2,3,2019-08-09,clear-night,nan
108,106,2,2019-02-07,cloudy,nan
0,0,0,2019-11-23,clear-night,nan
1084,666,418,2019-05-26,clear-day,nan
234,89,145,2019-02-11,cloudy,nan
147,66,81,2019-11-14,partly-cloudy-day,nan
2,1,1,2019-06-09,clear-night,nan
1454,742,712,2019-03-04,partly-cloudy-day,nan
2295,1109,1186,2019-09-27,clear-day,nan
0,0,0,2019-10-21,partly-cloudy-night,nan
92,64,28,2019-06-15,clear-night,nan
1,0,1,2019-03-22,rain,nan
32,25,7,2019-05-16,cloudy,nan
0,0,0,2019-01-31,clear-night,nan
2810,1227,1583,2019-08-25,partly-cloudy-day,nan
877,422,455,2019-07-30,clear-day,nan
23,21,2,2019-12-30,rain,nan
1712,926,786,2019-07-03,partly-cloudy-day,nan
379,145,234,2019-05-06,cloudy,nan
752,363,389,2019-06-26,clear-day,nan
1943,1078,865,2019-09-17,clear-day,nan
35,18,17,2019-02-04,clear-night,nan
63,59,4,2019-11-04,clear-night,nan
0,0,0,2019-11-09,clear-night,nan
211,111,100,2019-07-21,clear-day,nan
0,0,0,2019-11-18,cloudy,nan
635,309,326,2019-04-15,partly-cloudy-day,Tax Day
0,0,0,2019-11-04,clear-night,nan
1203,750,453,2019-09-11,partly-cloudy-day,nan
191,100,91,2019-09-06,partly-cloudy-night,nan
432,119,313,2019-05-22,clear-day,nan
1448,758,690,2019-01-06,partly-cloudy-day,nan
1604,705,899,2019-12-18,partly-cloudy-day,nan
419,162,257,2019-08-29,clear-day,nan
380,193,187,2019-10-20,rain,nan
198,81,117,2019-08-23,cloudy,nan
29,8,21,2019-01-02,cloudy,nan
2175,951,1224,2019-09-22,clear-day,nan
68,40,28,2019-06-26,partly-cloudy-night,nan
222,99,123,2019-07-30,clear-day,nan
92,87,5,2019-10-02,rain,nan
4141,2575,1566,2019-01-01,partly-cloudy-day,New Year's Day
56,19,37,2019-06-25,rain,nan
0,0,0,2019-11-20,cloudy,nan
2180,957,1223,2019-08-29,clear-day,nan
0,0,0,2019-07-14,clear-night,nan
1014,487,527,2019-05-28,cloudy,nan
0,0,0,2019-03-22,rain,nan
564,283,281,2019-07-16,clear-day,nan
49,46,3,2019-09-26,partly-cloudy-night,nan
18,11,7,2019-06-11,clear-night,nan
0,0,0,2019-11-21,clear-night,nan
249,83,166,2019-11-14,clear-day,nan
0,0,0,2019-08-07,partly-cloudy-night,nan
2,0,2,2019-12-19,partly-cloudy-night,nan
442,209,233,2019-10-23,clear-day,nan
2959,1278,1681,2019-08-31,partly-cloudy-day,nan
1267,540,727,2019-11-21,clear-day,nan
0,0,0,2019-12-23,clear-night,nan
2074,939,1135,2019-07-25,partly-cloudy-day,nan
2379,1179,1200,2019-12-24,clear-day,Christmas Eve
365,127,238,2019-09-12,partly-cloudy-day,nan
55,22,33,2019-01-07,cloudy,nan
235,70,165,2019-01-09,clear-day,nan
1,0,1,2019-07-03,partly-cloudy-night,nan
1632,819,813,2019-08-06,partly-cloudy-day,nan
0,0,0,2019-12-08,clear-night,nan
1207,705,502,2019-06-30,partly-cloudy-day,nan
549,277,272,2019-08-16,partly-cloudy-night,nan
0,0,0,2019-06-14,partly-cloudy-night,nan
1135,524,611,2019-04-16,partly-cloudy-day,nan
1611,763,848,2019-10-30,cloudy,nan
673,338,335,2019-02-05,cloudy,nan
1465,586,879,2019-11-06,clear-day,nan
4108,1236,2872,2019-12-28,clear-day,nan
348,198,150,2019-03-13,clear-day,nan
1771,862,909,2019-09-03,clear-day,nan
22,15,7,2019-01-03,partly-cloudy-night,nan
0,0,0,2019-08-12,clear-night,nan
1205,596,609,2019-12-06,cloudy,nan
1377,587,790,2019-03-08,clear-day,nan
20,11,9,2019-04-22,cloudy,nan
281,104,177,2019-04-30,cloudy,nan
2,0,2,2019-02-10,cloudy,nan
2171,949,1222,2019-01-03,partly-cloudy-day,nan
664,261,403,2019-06-05,partly-cloudy-day,nan
286,107,179,2019-03-20,clear-day,nan
1056,512,544,2019-03-01,cloudy,nan
15,11,4,2019-02-11,partly-cloudy-night,nan
1344,538,806,2019-09-12,partly-cloudy-day,nan
1710,943,767,2019-07-26,clear-day,nan
1705,872,833,2019-06-17,partly-cloudy-day,nan
1899,909,990,2019-11-17,cloudy,nan
359,196,163,2019-01-08,cloudy,nan
0,0,0,2019-02-24,cloudy,nan
1,0,1,2019-05-09,partly-cloudy-night,nan
1720,721,999,2019-06-19,cloudy,nan
1846,872,974,2019-05-10,partly-cloudy-day,nan
1,0,1,2019-10-15,clear-night,nan
0,0,0,2019-01-12,partly-cloudy-day,nan
19,9,10,2019-03-21,cloudy,nan
1,0,1,2019-08-13,partly-cloudy-night,nan
1188,539,649,2019-05-22,clear-day,nan
16,0,16,2019-01-29,rain,nan
1642,900,742,2019-10-10,partly-cloudy-day,nan
20,19,1,2019-10-27,cloudy,nan
2562,1190,1372,2019-04-14,partly-cloudy-day,nan
1557,635,922,2019-03-20,clear-day,nan
183,96,87,2019-09-17,clear-night,nan
1641,866,775,2019-07-15,partly-cloudy-day,nan
2662,1311,1351,2019-04-23,clear-day,nan
1729,700,1029,2019-06-08,clear-day,nan
2002,947,1055,2019-05-26,clear-day,nan
37,19,18,2019-09-30,cloudy,nan
1,0,1,2019-12-24,clear-night,Christmas Eve
861,455,406,2019-01-19,partly-cloudy-day,nan
17,14,3,2019-08-24,partly-cloudy-night,nan
0,0,0,2019-12-18,clear-night,nan
4,3,1,2019-07-01,clear-night,nan
169,67,102,2019-02-06,clear-night,nan
3,2,1,2019-12-13,clear-night,nan
0,0,0,2019-10-30,cloudy,nan
180,101,79,2019-09-13,clear-night,nan
2308,975,1333,2019-07-07,partly-cloudy-day,nan
2,1,1,2019-11-01,rain,nan
1561,829,732,2019-03-04,snow,nan
116,62,54,2019-02-28,partly-cloudy-day,nan
9,2,7,2019-06-27,clear-night,nan
2575,1154,1421,2019-11-02,partly-cloudy-day,nan
88,42,46,2019-06-13,cloudy,nan
697,324,373,2019-04-05,cloudy,nan
2421,1164,1257,2019-03-09,clear-day,nan
0,0,0,2019-10-11,clear-night,nan
230,100,130,2019-06-20,cloudy,nan
13,0,13,2019-10-29,cloudy,nan
2604,1199,1405,2019-02-16,clear-day,nan
0,0,0,2019-11-12,clear-night,nan
123,51,72,2019-06-25,partly-cloudy-night,nan
6,5,1,2019-01-21,clear-night,Martin Luther King Jr. Day
1944,1197,747,2019-07-01,clear-day,nan
5,2,3,2019-08-17,cloudy,nan
1609,869,740,2019-10-05,clear-day,nan
10,0,10,2019-04-09,cloudy,nan
1,0,1,2019-11-04,clear-night,nan
3250,1453,1797,2019-09-01,partly-cloudy-day,nan
202,92,110,2019-01-16,cloudy,nan
115,53,62,2019-01-26,clear-night,nan
2971,1269,1702,2019-08-11,partly-cloudy-day,nan
3,0,3,2019-12-20,clear-night,nan
0,0,0,2019-03-31,clear-night,nan
46,35,11,2019-05-20,partly-cloudy-night,nan
1456,717,739,2019-09-25,clear-day,nan
1850,846,1004,2019-07-14,clear-day,nan
667,261,406,2019-06-06,partly-cloudy-day,nan
94,28,66,2019-07-08,clear-night,nan
2038,902,1136,2019-06-12,partly-cloudy-day,nan
131,92,39,2019-01-04,clear-night,nan
670,314,356,2019-01-05,rain,nan
2788,1172,1616,2019-05-06,partly-cloudy-day,nan
24,8,16,2019-05-27,clear-night,nan
5,1,4,2019-06-15,clear-night,nan
50,49,1,2019-12-28,clear-night,nan
42,40,2,2019-10-27,partly-cloudy-night,nan
14,13,1,2019-10-23,clear-night,nan
798,338,460,2019-02-25,wind,nan
0,0,0,2019-11-26,clear-night,nan
1042,450,592,2019-01-11,clear-day,nan
561,256,305,2019-01-10,partly-cloudy-day,nan
5,3,2,2019-03-08,partly-cloudy-night,nan
2976,1296,1680,2019-05-25,partly-cloudy-day,nan
4,2,2,2019-10-14,cloudy,Columbus Day (regional holiday)
3,1,2,2019-05-28,clear-night,nan
1197,624,573,2019-04-25,cloudy,nan
2415,1086,1329,2019-06-30,partly-cloudy-day,nan
2604,1235,1369,2019-08-04,partly-cloudy-day,nan
370,186,184,2019-01-14,partly-cloudy-day,nan
2,1,1,2019-07-21,clear-night,nan
50,50,0,2019-12-07,clear-night,nan
1579,738,841,2019-11-11,clear-day,Veterans Day
666,298,368,2019-09-20,clear-day,nan
4,2,2,2019-01-21,partly-cloudy-night,Martin Luther King Jr. Day
52,40,12,2019-07-13,clear-night,nan
459,185,274,2019-04-22,partly-cloudy-day,Easter Monday
31,28,3,2019-04-30,cloudy,nan
7,5,2,2019-04-21,partly-cloudy-night,Easter Sunday
2170,957,1213,2019-09-05,partly-cloudy-day,nan
1254,660,594,2019-02-03,clear-day,nan
55,34,21,2019-05-24,clear-night,nan
2482,1256,1226,2019-08-03,partly-cloudy-day,nan
2616,1245,1371,2019-06-14,partly-cloudy-day,nan
1907,945,962,2019-11-11,clear-day,Veterans Day
0,0,0,2019-07-19,cloudy,nan
1332,615,717,2019-07-29,partly-cloudy-day,nan
1,1,0,2019-11-03,clear-night,nan
1,0,1,2019-05-30,cloudy,nan
59,39,20,2019-05-25,clear-night,nan
0,0,0,2019-02-25,wind,nan
13,9,4,2019-09-02,partly-cloudy-night,nan
3471,1756,1715,2019-12-29,cloudy,nan
14,13,1,2019-08-21,clear-night,nan
544,294,250,2019-09-04,partly-cloudy-day,nan
0,0,0,2019-09-15,partly-cloudy-night,nan
599,324,275,2019-07-31,partly-cloudy-day,nan
2,0,2,2019-10-18,partly-cloudy-night,nan
1,0,1,2019-11-20,partly-cloudy-night,nan
0,0,0,2019-01-15,clear-night,nan
5,3,2,2019-01-06,clear-night,nan
202,94,108,2019-07-08,rain,nan
1494,621,873,2019-12-05,partly-cloudy-day,nan
0,0,0,2019-12-22,clear-night,nan
0,0,0,2019-06-28,clear-night,nan
1982,756,1226,2019-04-07,clear-day,nan
1513,890,623,2019-07-13,clear-day,nan
7,0,7,2019-03-10,fog,Daylight Saving Time starts
2104,863,1241,2019-05-15,partly-cloudy-day,nan
64,61,3,2019-11-10,partly-cloudy-night,nan
890,394,496,2019-01-20,rain,nan
1,1,0,2019-03-23,partly-cloudy-night,nan
35,21,14,2019-07-15,clear-night,nan
1,0,1,2019-02-26,partly-cloudy-night,nan
21,9,12,2019-08-19,clear-night,nan
0,0,0,2019-02-09,clear-night,nan
1646,885,761,2019-07-12,clear-day,nan
322,151,171,2019-12-23,clear-day,nan
10,5,5,2019-07-11,partly-cloudy-night,nan
1755,823,932,2019-03-23,clear-day,nan
0,0,0,2019-10-27,cloudy,nan
1461,626,835,2019-04-17,clear-day,nan
224,136,88,2019-06-13,rain,nan
0,0,0,2019-08-10,clear-night,nan
0,0,0,2019-05-01,cloudy,nan
1792,1003,789,2019-09-07,clear-day,nan
1,1,0,2019-06-01,clear-night,nan
936,442,494,2019-08-10,partly-cloudy-day,nan
33,23,10,2019-08-17,partly-cloudy-night,nan
33,29,4,2019-12-01,clear-night,nan
192,159,33,2019-01-15,clear-night,nan
3093,1250,1843,2019-10-05,clear-day,nan
3185,1472,1713,2019-09-14,cloudy,nan
1072,560,512,2019-07-23,cloudy,nan
1161,453,708,2019-12-10,cloudy,nan
1501,744,757,2019-08-26,partly-cloudy-day,nan
1617,799,818,2019-01-04,clear-day,nan
25,0,25,2019-02-08,clear-night,nan
1,1,0,2019-03-23,cloudy,nan
1358,760,598,2019-12-15,clear-day,nan
67,34,33,2019-05-14,rain,nan
40,0,40,2019-11-23,rain,nan
2632,1308,1324,2019-05-18,clear-day,nan
0,0,0,2019-02-12,partly-cloudy-night,nan
1617,971,646,2019-07-16,partly-cloudy-day,nan
0,0,0,2019-10-13,clear-night,nan
839,531,308,2019-08-24,clear-day,nan
1447,873,574,2019-08-16,partly-cloudy-day,nan
1577,870,707,2019-07-09,partly-cloudy-day,nan
549,292,257,2019-02-08,cloudy,nan
24,22,2,2019-05-10,cloudy,nan
183,90,93,2019-06-10,rain,nan
13,11,2,2019-04-02,cloudy,nan
17,15,2,2019-08-30,clear-night,nan
25,23,2,2019-11-18,cloudy,nan
1758,760,998,2019-10-08,cloudy,nan
2,0,2,2019-08-23,rain,nan
407,170,237,2019-07-19,cloudy,nan
1350,644,706,2019-11-22,cloudy,nan
348,183,165,2019-03-14,partly-cloudy-day,nan
2382,1040,1342,2019-11-01,clear-day,nan
0,0,0,2019-03-12,partly-cloudy-night,nan
237,96,141,2019-05-01,cloudy,nan
67,50,17,2019-07-26,clear-night,nan
1417,706,711,2019-07-18,rain,nan
193,193,0,2019-02-19,clear-day,nan
0,0,0,2019-05-22,clear-night,nan
821,486,335,2019-03-28,clear-day,nan
3,1,2,2019-10-22,clear-night,nan
7,5,2,2019-01-13,clear-night,nan
1,0,1,2019-04-23,cloudy,nan
34,31,3,2019-03-02,cloudy,nan
728,355,373,2019-01-28,clear-day,nan
10,4,6,2019-08-04,partly-cloudy-night,nan
3,0,3,2019-09-14,partly-cloudy-night,nan
0,0,0,2019-11-02,clear-night,nan
11,10,1,2019-05-05,rain,nan
3,0,3,2019-03-07,partly-cloudy-night,nan
0,0,0,2019-12-31,cloudy,New Year's Eve
6,5,1,2019-10-07,rain,nan
1330,529,801,2019-12-03,partly-cloudy-day,nan
745,371,374,2019-01-23,cloudy,nan
0,0,0,2019-03-26,partly-cloudy-night,nan
883,553,330,2019-04-30,cloudy,nan
774,475,299,2019-06-23,clear-day,nan
0,0,0,2019-04-29,clear-night,nan
0,0,0,2019-08-30,clear-night,nan
4,3,1,2019-10-19,clear-night,nan
29,25,4,2019-08-08,partly-cloudy-night,nan
5,5,0,2019-12-07,clear-night,nan
2088,941,1147,2019-08-15,partly-cloudy-day,nan
1447,751,696,2019-07-09,clear-day,nan
1894,898,996,2019-04-12,partly-cloudy-day,nan
360,188,172,2019-11-24,rain,nan
608,264,344,2019-10-31,rain,Halloween
7,6,1,2019-12-25,clear-night,Christmas Day
124,86,38,2019-11-13,clear-night,nan
0,0,0,2019-03-19,clear-night,nan
529,233,296,2019-03-27,clear-day,nan
2497,1185,1312,2019-11-30,clear-day,nan
0,0,0,2019-08-21,clear-night,nan
3291,1460,1831,2019-10-13,partly-cloudy-day,nan
2,2,0,2019-01-09,partly-cloudy-night,nan
2281,1061,1220,2019-04-12,partly-cloudy-day,nan
106,67,39,2019-04-04,clear-night,nan
1,0,1,2019-03-04,snow,nan
4,3,1,2019-07-18,rain,nan
2,1,1,2019-02-13,cloudy,nan
1431,629,802,2019-07-17,partly-cloudy-day,nan
3152,1440,1712,2019-04-06,partly-cloudy-day,nan
1900,748,1152,2019-06-29,partly-cloudy-day,nan
0,0,0,2019-02-02,clear-night,nan
1756,784,972,2019-09-18,partly-cloudy-day,nan
3,0,3,2019-08-07,partly-cloudy-night,nan
4,2,2,2019-10-09,cloudy,nan
46,14,32,2019-01-24,rain,nan
1117,591,526,2019-12-11,partly-cloudy-day,nan
2114,1131,983,2019-05-24,partly-cloudy-day,nan
39,18,21,2019-08-15,partly-cloudy-night,nan
0,0,0,2019-10-24,clear-night,nan
1189,587,602,2019-10-11,cloudy,nan
2,0,2,2019-09-11,partly-cloudy-night,nan
280,131,149,2019-12-02,snow,nan
0,0,0,2019-03-01,partly-cloudy-night,nan
1411,596,815,2019-11-08,clear-day,nan
53,31,22,2019-12-11,snow,nan
849,449,400,2019-10-09,cloudy,nan
63,62,1,2019-12-05,cloudy,nan
1821,711,1110,2019-01-27,cloudy,nan
24,23,1,2019-05-24,partly-cloudy-night,nan
57,52,5,2019-04-19,cloudy,nan
0,0,0,2019-12-25,clear-night,Christmas Day
5,3,2,2019-10-31,rain,Halloween
1575,788,787,2019-03-15,partly-cloudy-day,nan
1,0,1,2019-10-01,clear-night,nan
56,45,11,2019-10-30,cloudy,nan
898,565,333,2019-07-27,clear-day,nan
188,93,95,2019-07-04,clear-day,Independence Day
1970,869,1101,2019-07-24,partly-cloudy-day,nan
6,0,6,2019-03-21,cloudy,nan
615,299,316,2019-02-01,partly-cloudy-day,nan
0,0,0,2019-01-29,clear-night,nan
1,0,1,2019-04-13,cloudy,nan
3,1,2,2019-06-19,cloudy,nan
2682,1100,1582,2019-10-06,cloudy,nan
0,0,0,2019-05-08,cloudy,nan
29,27,2,2019-09-12,cloudy,nan
2957,1381,1576,2019-06-01,clear-day,nan
43,35,8,2019-09-24,partly-cloudy-night,nan
1598,678,920,2019-07-22,partly-cloudy-day,nan
1,0,1,2019-05-19,partly-cloudy-night,nan
1003,567,436,2019-04-01,clear-day,nan
1,0,1,2019-04-29,clear-night,nan
17,12,5,2019-08-25,partly-cloudy-night,nan
467,207,260,2019-10-04,clear-day,nan
34,31,3,2019-10-12,partly-cloudy-night,nan
0,0,0,2019-04-08,clear-night,nan
40,31,9,2019-09-13,partly-cloudy-night,nan
2036,842,1194,2019-06-24,partly-cloudy-day,nan
0,0,0,2019-12-16,clear-night,nan
305,160,145,2019-01-21,partly-cloudy-day,Martin Luther King Jr. Day
132,53,79,2019-08-27,partly-cloudy-night,nan
276,117,159,2019-02-15,cloudy,nan
790,382,408,2019-05-05,cloudy,Cinco de Mayo
1533,758,775,2019-09-09,partly-cloudy-day,nan
276,109,167,2019-05-14,cloudy,nan
201,88,113,2019-04-02,clear-day,nan
2,2,0,2019-02-20,clear-night,nan
0,0,0,2019-09-19,clear-night,nan
284,201,83,2019-03-02,cloudy,nan
52,40,12,2019-10-05,partly-cloudy-night,nan
1913,915,998,2019-03-17,partly-cloudy-day,St. Patrick's Day
1368,689,679,2019-03-29,partly-cloudy-day,nan
18,11,7,2019-01-10,cloudy,nan
25,24,1,2019-03-28,cloudy,nan
4,4,0,2019-11-25,clear-night,nan
22,16,6,2019-10-08,partly-cloudy-night,nan
63,48,15,2019-06-13,cloudy,nan
0,0,0,2019-05-29,partly-cloudy-night,nan
0,0,0,2019-10-22,clear-night,nan
2310,1087,1223,2019-08-09,partly-cloudy-day,nan
6,5,1,2019-10-31,cloudy,nan
2523,1253,1270,2019-07-05,partly-cloudy-day,nan
1317,669,648,2019-01-25,partly-cloudy-day,nan
1199,702,497,2019-07-22,partly-cloudy-day,nan
281,103,178,2019-11-06,clear-day,nan
1,0,1,2019-03-03,partly-cloudy-night,nan
4,3,1,2019-05-07,cloudy,nan
65,56,9,2019-04-13,partly-cloudy-night,nan
276,144,132,2019-01-21,clear-day,Martin Luther King Jr. Day
4,1,3,2019-06-05,clear-night,nan
8,3,5,2019-01-19,snow,nan
23,9,14,2019-06-23,clear-night,nan
71,61,10,2019-10-19,clear-night,nan
0,0,0,2019-12-17,rain,nan
1814,751,1063,2019-10-17,cloudy,nan
1282,546,736,2019-02-14,clear-day,Valentine's Day
3,0,3,2019-11-22,clear-night,nan
1,0,1,2019-10-08,cloudy,nan
0,0,0,2019-11-29,partly-cloudy-night,Black Friday
73,66,7,2019-12-22,clear-night,nan
0,0,0,2019-01-16,partly-cloudy-night,nan
6,0,6,2019-12-09,rain,nan
540,292,248,2019-05-18,clear-day,nan
2577,1152,1425,2019-10-14,clear-day,Columbus Day (regional holiday)
21,11,10,2019-09-11,partly-cloudy-night,nan
0,0,0,2019-12-28,clear-night,nan
1336,602,734,2019-07-25,clear-day,nan
152,77,75,2019-08-21,partly-cloudy-night,nan
561,238,323,2019-01-30,clear-day,nan
783,371,412,2019-01-10,partly-cloudy-day,nan
439,160,279,2019-10-15,clear-day,nan
393,155,238,2019-03-21,cloudy,nan
315,140,175,2019-09-04,cloudy,nan
7,4,3,2019-10-14,clear-night,nan
1975,1023,952,2019-12-26,partly-cloudy-day,nan
3,0,3,2019-05-05,rain,Cinco de Mayo
1779,927,852,2019-05-07,partly-cloudy-day,nan
12,6,6,2019-05-29,cloudy,nan
180,160,20,2019-02-06,cloudy,nan
1622,835,787,2019-07-09,clear-day,nan
1418,728,690,2019-04-01,clear-day,nan
0,0,0,2019-01-05,rain,nan
971,450,521,2019-12-19,clear-day,nan
3,1,2,2019-06-29,clear-night,nan
21,0,21,2019-10-16,rain,nan
3524,1532,1992,2019-04-21,partly-cloudy-day,Easter Sunday
1441,515,926,2019-06-16,cloudy,Father's Day
19,9,10,2019-02-12,cloudy,nan
2,1,1,2019-03-01,cloudy,nan
1,0,1,2019-03-19,clear-night,nan
23,22,1,2019-12-14,cloudy,nan
48,11,37,2019-06-02,partly-cloudy-night,nan
166,78,88,2019-07-17,partly-cloudy-day,nan
21,0,21,2019-12-06,cloudy,nan
1388,623,765,2019-02-10,clear-day,nan
305,168,137,2019-11-10,partly-cloudy-day,nan
0,0,0,2019-11-07,clear-night,nan
1437,613,824,2019-04-26,cloudy,nan
981,476,505,2019-09-10,partly-cloudy-day,nan
0,0,0,2018-02-05,clear-night,nan
0,0,0,2017-12-30,clear-night,nan
225,99,126,2017-10-27,clear-night,nan
2,1,1,2017-11-07,clear-night,nan
196,102,94,2017-10-03,clear-night,nan
1724,915,809,2017-12-31,partly-cloudy-day,New Year's Eve
74,50,24,2018-02-03,clear-night,nan
17,3,14,2017-11-25,clear-night,nan
480,266,214,2017-12-09,partly-cloudy-day,nan
9,5,4,2017-11-13,partly-cloudy-night,nan
966,455,511,2018-01-26,clear-day,nan
714,341,373,2018-01-18,clear-day,nan
4,0,4,2017-12-06,partly-cloudy-night,nan
2649,1152,1497,2017-12-02,clear-day,nan
2,0,2,2018-01-11,partly-cloudy-night,nan
2281,1232,1049,2017-11-03,partly-cloudy-day,nan
129,63,66,2017-12-18,partly-cloudy-night,nan
1779,667,1112,2017-11-25,clear-night,nan
1674,792,882,2017-12-11,partly-cloudy-day,nan
61,35,26,2017-12-27,cloudy,nan
361,237,124,2017-11-28,clear-night,nan
22,13,9,2017-10-27,clear-night,nan
59,38,21,2018-01-17,clear-night,nan
2085,786,1299,2017-11-12,clear-day,nan
23,15,8,2017-12-01,clear-night,nan
18,12,6,2017-10-16,partly-cloudy-night,nan
103,30,73,2018-01-23,rain,nan
17,9,8,2017-11-27,clear-night,nan
1470,834,636,2017-10-06,clear-day,nan
307,136,171,2018-01-29,clear-day,nan
38,29,9,2017-12-15,clear-night,nan
2069,895,1174,2017-11-19,partly-cloudy-day,nan
986,422,564,2017-11-18,partly-cloudy-day,nan
199,123,76,2018-01-04,snow,nan
0,0,0,2018-01-05,clear-night,nan
1814,894,920,2017-11-01,partly-cloudy-day,nan
652,341,311,2018-01-06,clear-day,nan
19,12,7,2017-10-05,partly-cloudy-night,nan
39,16,23,2018-01-06,clear-day,nan
125,62,63,2018-02-03,clear-day,nan
69,28,41,2017-12-27,clear-night,nan
236,123,113,2017-12-28,clear-night,nan
1278,543,735,2017-11-30,partly-cloudy-day,nan
2616,1445,1171,2017-12-24,clear-day,Christmas Eve
9,6,3,2017-12-08,clear-night,nan
404,271,133,2018-01-24,clear-night,nan
208,88,120,2017-12-26,clear-day,nan
966,439,527,2017-12-13,clear-day,nan
3,0,3,2017-12-23,partly-cloudy-night,nan
111,56,55,2018-01-03,clear-night,nan
180,73,107,2017-10-20,clear-night,nan
40,14,26,2017-12-04,partly-cloudy-night,nan
9,5,4,2017-11-16,partly-cloudy-night,nan
1949,1130,819,2017-10-15,partly-cloudy-day,nan
19,6,13,2017-12-12,partly-cloudy-night,nan
841,437,404,2018-01-09,clear-day,nan
236,150,86,2018-01-28,partly-cloudy-night,nan
1855,802,1053,2017-11-21,clear-day,nan
148,125,23,2017-11-05,partly-cloudy-night,Daylight Saving Time ends
6,6,0,2017-11-07,rain,nan
432,251,181,2018-01-30,partly-cloudy-day,nan
393,162,231,2017-10-14,cloudy,nan
4,3,1,2017-10-27,clear-night,nan
43,14,29,2017-11-12,clear-night,nan
535,244,291,2017-10-11,clear-day,nan
1219,595,624,2018-01-11,partly-cloudy-day,nan
6,0,6,2017-12-19,cloudy,nan
27,14,13,2017-11-07,clear-night,nan
1432,632,800,2017-12-16,cloudy,nan
539,258,281,2017-11-24,clear-night,Black Friday
2,1,1,2018-01-25,clear-night,nan
0,0,0,2018-01-17,partly-cloudy-night,nan
3093,1510,1583,2017-10-22,clear-day,nan
12,6,6,2017-12-17,partly-cloudy-night,nan
8,5,3,2018-01-13,cloudy,nan
3,2,1,2018-01-10,clear-night,nan
116,41,75,2018-01-12,cloudy,nan
4,2,2,2017-11-15,partly-cloudy-night,nan
5,4,1,2017-11-10,clear-night,Veterans Day observed
1772,824,948,2017-12-22,partly-cloudy-day,nan
2098,1012,1086,2017-10-20,clear-day,nan
889,448,441,2018-01-15,partly-cloudy-day,Martin Luther King Jr. Day
1535,933,602,2017-10-10,clear-day,nan
8,4,4,2018-01-15,clear-night,Martin Luther King Jr. Day
19,10,9,2017-11-09,clear-night,nan
44,30,14,2017-10-01,clear-night,nan
3,1,2,2017-11-19,partly-cloudy-night,nan
1,0,1,2018-01-06,clear-night,nan
579,325,254,2017-11-02,partly-cloudy-day,nan
5,2,3,2017-10-24,partly-cloudy-night,nan
1534,589,945,2017-10-28,clear-night,nan
155,103,52,2017-12-15,partly-cloudy-night,nan
45,29,16,2017-11-23,clear-night,Thanksgiving Day
1361,561,800,2017-12-21,clear-day,nan
51,28,23,2017-12-21,clear-night,nan
1733,964,769,2017-10-04,clear-day,nan
1781,766,1015,2017-12-04,clear-day,nan
41,38,3,2018-01-04,partly-cloudy-night,nan
800,461,339,2017-12-04,clear-night,nan
32,17,15,2017-11-16,partly-cloudy-night,nan
20,15,5,2017-12-10,clear-night,nan
29,16,13,2017-10-21,clear-night,nan
2824,1280,1544,2017-10-15,partly-cloudy-day,nan
589,286,303,2018-01-02,clear-night,nan
432,250,182,2018-01-07,clear-day,nan
92,48,44,2017-12-17,partly-cloudy-night,nan
28,6,22,2017-11-20,partly-cloudy-night,nan
2031,936,1095,2017-12-26,clear-day,nan
84,65,19,2017-12-12,partly-cloudy-night,nan
23,11,12,2017-10-18,clear-night,nan
638,263,375,2017-11-10,clear-night,Veterans Day observed
46,25,21,2017-10-08,partly-cloudy-night,nan
1252,606,646,2017-11-20,partly-cloudy-day,nan
739,249,490,2017-10-22,clear-night,nan
28,20,8,2017-11-18,clear-night,nan
4,2,2,2018-01-05,clear-night,nan
1674,763,911,2018-01-13,clear-day,nan
104,66,38,2017-10-25,clear-night,nan
6,4,2,2018-02-02,partly-cloudy-night,nan
834,442,392,2017-11-01,partly-cloudy-night,nan
4,3,1,2017-12-20,partly-cloudy-night,nan
156,74,82,2017-11-11,clear-night,Veterans Day
16,7,9,2018-01-01,clear-night,New Year's Day
6,3,3,2017-12-28,clear-night,nan
694,351,343,2018-01-31,clear-day,nan
1166,444,722,2017-12-06,clear-day,nan
1167,451,716,2017-11-28,clear-day,nan
635,250,385,2017-10-05,clear-night,nan
2701,1375,1326,2017-12-27,clear-day,nan
640,302,338,2017-10-29,partly-cloudy-day,nan
1667,945,722,2017-10-31,clear-day,Halloween
512,233,279,2017-11-23,clear-night,Thanksgiving Day
768,418,350,2017-12-18,cloudy,nan
13,7,6,2017-10-10,partly-cloudy-night,nan
1663,842,821,2017-10-12,partly-cloudy-day,nan
56,18,38,2018-01-01,clear-night,New Year's Day
32,14,18,2018-01-18,clear-night,nan
1079,462,617,2017-11-14,partly-cloudy-day,nan
39,28,11,2018-01-26,partly-cloudy-night,nan
1238,603,635,2017-12-03,partly-cloudy-day,nan
0,0,0,2018-01-19,clear-night,nan
45,32,13,2018-01-12,rain,nan
4,2,2,2018-01-08,partly-cloudy-night,nan
192,146,46,2018-01-08,cloudy,nan
0,0,0,2018-01-30,partly-cloudy-night,nan
75,27,48,2017-12-25,clear-night,Christmas Day
1,0,1,2017-11-30,clear-night,nan
845,422,423,2018-01-24,partly-cloudy-day,nan
159,51,108,2017-12-15,clear-day,nan
176,105,71,2018-01-19,clear-night,nan
890,494,396,2017-12-07,clear-day,nan
953,494,459,2017-11-11,clear-day,Veterans Day
44,24,20,2018-01-14,clear-night,nan
475,217,258,2018-02-04,partly-cloudy-day,nan
2,0,2,2018-02-01,partly-cloudy-night,nan
35,18,17,2018-01-16,clear-night,nan
383,180,203,2017-11-28,clear-day,nan
78,46,32,2017-11-29,clear-night,nan
370,157,213,2017-10-13,partly-cloudy-night,nan
297,216,81,2018-01-31,clear-night,nan
337,138,199,2017-12-05,partly-cloudy-day,nan
256,154,102,2017-12-20,clear-night,nan
2294,1029,1265,2018-01-02,clear-day,nan
105,53,52,2017-10-31,clear-night,Halloween
840,449,391,2017-11-14,partly-cloudy-night,nan
116,64,52,2018-01-20,clear-night,nan
389,146,243,2017-12-04,partly-cloudy-day,nan
1586,806,780,2018-01-20,clear-day,nan
72,35,37,2017-12-23,partly-cloudy-night,nan
16,12,4,2017-10-01,partly-cloudy-night,nan
27,16,11,2017-12-12,partly-cloudy-night,nan
503,261,242,2017-11-06,cloudy,nan
1191,579,612,2018-02-03,partly-cloudy-day,nan
15,9,6,2017-11-20,partly-cloudy-night,nan
2101,1227,874,2017-10-19,clear-day,nan
50,21,29,2017-10-06,partly-cloudy-night,nan
1793,945,848,2017-12-27,clear-day,nan
6,1,5,2018-01-04,partly-cloudy-night,nan
277,142,135,2017-10-11,clear-night,nan
160,63,97,2017-12-06,cloudy,nan
2,1,1,2017-12-28,clear-night,nan
2,2,0,2018-01-27,clear-night,nan
1583,686,897,2017-11-17,clear-day,nan
429,171,258,2017-10-16,clear-night,nan
95,46,49,2017-11-22,clear-night,nan
1587,714,873,2017-11-06,partly-cloudy-day,nan
402,129,273,2017-10-19,clear-day,nan
272,148,124,2017-10-28,clear-night,nan
213,133,80,2017-10-22,clear-night,nan
14,7,7,2018-01-08,cloudy,nan
2,0,2,2017-12-22,clear-night,nan
405,212,193,2017-12-14,clear-night,nan
141,76,65,2018-01-27,partly-cloudy-night,nan
271,150,121,2017-12-03,clear-night,nan
1791,814,977,2017-10-26,partly-cloudy-day,nan
2043,907,1136,2017-12-10,clear-day,nan
7,6,1,2017-10-12,partly-cloudy-night,nan
1,0,1,2017-10-29,partly-cloudy-night,nan
497,304,193,2017-11-24,clear-day,Black Friday
888,446,442,2017-10-09,partly-cloudy-day,Columbus Day (regional holiday)
188,90,98,2017-10-25,clear-night,nan
168,131,37,2017-11-29,clear-night,nan
197,104,93,2017-11-13,partly-cloudy-day,nan
111,57,54,2017-11-05,partly-cloudy-night,Daylight Saving Time ends
143,99,44,2017-11-18,partly-cloudy-night,nan
144,98,46,2017-12-01,clear-night,nan
754,418,336,2017-12-02,clear-day,nan
2478,1906,572,2017-10-01,clear-day,nan
1493,825,668,2017-12-31,clear-day,New Year's Eve
9,6,3,2017-12-11,cloudy,nan
1176,504,672,2018-02-03,clear-day,nan
138,94,44,2017-11-14,partly-cloudy-night,nan
815,359,456,2017-12-14,partly-cloudy-day,nan
629,366,263,2017-11-29,partly-cloudy-day,nan
652,364,288,2017-12-09,fog,nan
26,15,11,2017-12-07,partly-cloudy-night,nan
7,3,4,2017-10-17,clear-night,nan
31,16,15,2017-10-17,clear-night,nan
390,162,228,2017-10-03,clear-day,nan
77,54,23,2017-12-08,partly-cloudy-night,nan
503,275,228,2017-11-17,clear-day,nan
376,201,175,2018-01-17,partly-cloudy-day,nan
124,55,69,2018-01-20,clear-night,nan
1,0,1,2017-12-13,clear-night,nan
2344,1030,1314,2017-11-24,clear-day,Black Friday
24,14,10,2017-10-23,partly-cloudy-night,nan
0,0,0,2018-02-03,clear-night,nan
421,167,254,2017-12-24,partly-cloudy-night,Christmas Eve
127,58,69,2017-10-23,clear-night,nan
238,100,138,2017-10-06,clear-night,nan
5,2,3,2018-01-23,fog,nan
510,252,258,2018-01-30,rain,nan
11,10,1,2018-02-04,rain,nan
140,59,81,2017-12-12,partly-cloudy-night,nan
455,276,179,2017-12-17,clear-night,nan
514,245,269,2017-10-21,clear-night,nan
12,2,10,2017-12-31,clear-night,New Year's Eve
1910,871,1039,2017-11-18,clear-day,nan
39,13,26,2017-12-23,cloudy,nan
21,17,4,2017-11-03,partly-cloudy-night,nan
749,361,388,2018-01-05,clear-day,nan
409,178,231,2017-10-30,clear-night,nan
12,7,5,2018-01-11,partly-cloudy-night,nan
11,4,7,2018-01-31,clear-night,nan
5,3,2,2017-11-23,clear-night,Thanksgiving Day
2,0,2,2017-12-29,partly-cloudy-night,nan
412,245,167,2018-01-10,clear-day,nan
42,16,26,2017-12-18,partly-cloudy-night,nan
9,4,5,2018-01-22,cloudy,nan
2213,1207,1006,2017-10-20,clear-day,nan
535,280,255,2017-11-21,clear-day,nan
114,60,54,2017-11-03,clear-night,nan
147,69,78,2017-11-25,clear-day,nan
3,2,1,2018-01-12,partly-cloudy-night,nan
541,277,264,2018-01-18,clear-day,nan
134,67,67,2017-12-30,partly-cloudy-day,nan
1043,514,529,2017-11-22,partly-cloudy-day,nan
10,2,8,2017-10-30,partly-cloudy-night,nan
150,121,29,2017-12-19,clear-night,nan
233,107,126,2017-12-22,partly-cloudy-night,nan
755,346,409,2018-01-11,partly-cloudy-day,nan
250,97,153,2017-12-13,partly-cloudy-day,nan
287,130,157,2017-11-25,partly-cloudy-night,nan
0,0,0,2017-11-01,clear-night,nan
4,3,1,2017-11-08,partly-cloudy-night,nan
295,98,197,2017-12-08,clear-day,nan
527,251,276,2018-01-16,partly-cloudy-day,nan
89,50,39,2018-01-29,partly-cloudy-night,nan
469,251,218,2017-11-09,partly-cloudy-day,nan
169,74,95,2017-11-14,clear-day,nan
752,417,335,2017-12-21,clear-day,nan
1821,885,936,2018-01-27,clear-day,nan
9,6,3,2017-10-15,partly-cloudy-night,nan
9,6,3,2017-12-25,cloudy,Christmas Day
1224,684,540,2017-10-23,partly-cloudy-day,nan
1080,591,489,2017-11-26,partly-cloudy-day,nan
989,655,334,2017-10-07,partly-cloudy-day,nan
1020,622,398,2017-12-29,clear-day,nan
547,256,291,2017-12-02,clear-night,nan
86,48,38,2017-11-20,clear-night,nan
384,204,180,2017-11-08,partly-cloudy-night,nan
42,20,22,2018-01-07,clear-day,nan
480,305,175,2017-11-30,clear-night,nan
254,124,130,2017-10-28,partly-cloudy-night,nan
81,39,42,2018-01-16,cloudy,nan
3130,1525,1605,2017-11-04,clear-day,nan
41,24,17,2017-10-08,partly-cloudy-night,nan
1193,553,640,2017-11-15,partly-cloudy-day,nan
236,113,123,2017-10-17,clear-night,nan
255,107,148,2017-11-19,partly-cloudy-night,nan
420,297,123,2017-12-12,partly-cloudy-night,nan
1073,632,441,2017-11-07,clear-day,nan
2485,1241,1244,2017-10-08,clear-day,nan
1437,722,715,2017-12-16,partly-cloudy-day,nan
58,28,30,2018-01-01,clear-day,New Year's Day
37,23,14,2018-01-06,clear-night,nan
1077,450,627,2017-11-11,clear-night,Veterans Day
563,299,264,2018-01-22,partly-cloudy-day,nan
252,195,57,2018-02-01,partly-cloudy-night,nan
5,2,3,2017-12-25,partly-cloudy-night,Christmas Day
181,48,133,2018-01-10,clear-day,nan
590,358,232,2017-12-19,clear-night,nan
77,51,26,2018-01-12,fog,nan
485,316,169,2017-11-21,clear-night,nan
63,46,17,2017-11-16,partly-cloudy-night,nan
1,0,1,2018-01-24,clear-night,nan
4,1,3,2018-01-15,partly-cloudy-night,Martin Luther King Jr. Day
29,15,14,2017-12-14,partly-cloudy-night,nan
1659,1055,604,2017-10-02,clear-day,nan
205,98,107,2018-02-02,clear-day,nan
336,146,190,2018-01-01,clear-night,New Year's Day
30,16,14,2017-11-27,clear-night,nan
696,335,361,2017-12-05,partly-cloudy-day,nan
2073,991,1082,2017-11-02,partly-cloudy-day,nan
10,4,6,2017-11-30,clear-night,nan
1914,960,954,2017-10-30,partly-cloudy-day,nan
0,0,0,2017-12-24,clear-night,Christmas Eve
29,19,10,2017-11-05,partly-cloudy-night,Daylight Saving Time ends
523,270,253,2017-10-18,clear-day,nan
60,20,40,2017-10-02,clear-night,nan
1113,522,591,2017-11-10,clear-day,Veterans Day observed
100,51,49,2017-11-06,partly-cloudy-night,nan
936,394,542,2017-11-13,partly-cloudy-day,nan
47,29,18,2017-10-13,clear-night,nan
26,11,15,2017-12-07,clear-night,nan
184,60,124,2017-12-23,partly-cloudy-night,nan
1607,842,765,2017-12-20,clear-day,nan
433,210,223,2017-12-08,partly-cloudy-night,nan
1721,722,999,2017-12-08,clear-day,nan
19,15,4,2017-12-20,clear-night,nan
70,32,38,2018-01-29,clear-night,nan
1862,855,1007,2017-11-26,clear-day,nan
727,403,324,2017-12-06,clear-night,nan
580,364,216,2017-11-27,clear-night,nan
2016,983,1033,2017-10-13,partly-cloudy-day,nan
619,307,312,2017-12-26,clear-night,nan
329,236,93,2017-12-11,clear-night,nan
1425,604,821,2017-12-01,clear-day,nan
555,372,183,2017-10-14,partly-cloudy-day,nan
1577,822,755,2017-12-30,partly-cloudy-day,nan
1413,419,994,2017-10-24,partly-cloudy-day,nan
72,22,50,2017-11-26,clear-night,nan
97,36,61,2018-01-13,clear-night,nan
11,2,9,2018-01-09,cloudy,nan
0,0,0,2017-12-26,clear-night,nan
811,368,443,2018-01-26,clear-day,nan
1022,433,589,2017-12-03,partly-cloudy-night,nan
140,129,11,2017-12-21,partly-cloudy-night,nan
662,351,311,2018-01-26,clear-day,nan
3,2,1,2017-10-19,clear-night,nan
1,0,1,2017-12-15,clear-night,nan
9,4,5,2017-12-29,clear-night,nan
1753,898,855,2017-10-02,clear-day,nan
276,110,166,2017-12-19,partly-cloudy-day,nan
53,42,11,2017-12-03,partly-cloudy-night,nan
837,400,437,2017-11-22,partly-cloudy-night,nan
62,30,32,2017-12-10,partly-cloudy-night,nan
726,385,341,2018-01-14,clear-day,nan
5,3,2,2018-01-09,partly-cloudy-night,nan
5,3,2,2017-11-21,clear-night,nan
1599,759,840,2017-12-07,clear-day,nan
593,328,265,2017-12-01,clear-night,nan
27,15,12,2017-10-02,clear-night,nan
46,22,24,2017-11-22,partly-cloudy-night,nan
657,319,338,2018-01-28,partly-cloudy-day,nan
1843,851,992,2017-12-18,partly-cloudy-day,nan
3,0,3,2017-10-28,clear-night,nan
10,7,3,2018-02-01,clear-night,nan
1713,820,893,2017-10-11,partly-cloudy-day,nan
1004,478,526,2018-01-19,clear-day,nan
10,6,4,2017-10-17,clear-night,nan
266,182,84,2017-12-07,clear-night,nan
8,3,5,2017-10-03,clear-night,nan
53,28,25,2017-11-13,clear-night,nan
787,394,393,2017-11-28,clear-night,nan
2,1,1,2017-10-31,clear-night,Halloween
2298,1168,1130,2017-11-23,clear-day,Thanksgiving Day
2463,1339,1124,2017-10-01,clear-day,nan
14,8,6,2017-12-11,partly-cloudy-night,nan
181,109,72,2018-01-17,partly-cloudy-day,nan
5,2,3,2018-01-06,clear-night,nan
524,222,302,2018-01-30,partly-cloudy-day,nan
1,0,1,2018-02-04,partly-cloudy-night,nan
1396,820,576,2017-10-24,partly-cloudy-night,nan
883,414,469,2017-12-14,clear-day,nan
1211,561,650,2017-11-29,clear-day,nan
24,19,5,2018-01-22,fog,nan
55,33,22,2018-01-26,clear-night,nan
970,480,490,2017-12-22,partly-cloudy-night,nan
22,9,13,2017-12-24,cloudy,Christmas Eve
2531,1224,1307,2017-10-08,partly-cloudy-day,nan
656,391,265,2018-01-21,clear-day,nan
146,45,101,2017-12-13,clear-day,nan
9,4,5,2017-12-09,partly-cloudy-night,nan
8,7,1,2017-11-24,clear-night,Black Friday
6,3,3,2018-01-20,clear-night,nan
47,22,25,2017-10-30,clear-night,nan
609,348,261,2018-01-06,clear-day,nan
2334,1338,996,2017-11-02,clear-day,nan
6,4,2,2018-02-04,rain,nan
1995,958,1037,2018-01-03,clear-day,nan
283,207,76,2018-01-23,partly-cloudy-night,nan
1667,880,787,2017-10-16,clear-day,nan
147,85,62,2017-10-22,clear-night,nan
48,19,29,2017-12-17,partly-cloudy-night,nan
1812,908,904,2017-10-05,partly-cloudy-day,nan
277,178,99,2018-01-21,partly-cloudy-night,nan
1257,603,654,2017-12-19,partly-cloudy-day,nan
6,4,2,2018-01-13,cloudy,nan
1516,886,630,2017-11-25,clear-day,nan
110,63,47,2018-01-10,partly-cloudy-night,nan
1441,674,767,2017-12-17,cloudy,nan
1516,692,824,2017-11-22,partly-cloudy-day,nan
174,107,67,2018-01-01,clear-day,New Year's Day
1987,982,1005,2017-10-25,partly-cloudy-day,nan
16,6,10,2017-11-25,clear-night,nan
357,179,178,2017-10-26,clear-night,nan
210,98,112,2017-11-04,clear-night,nan
199,142,57,2017-12-02,clear-night,nan
661,340,321,2018-01-03,partly-cloudy-night,nan
28,17,11,2017-11-08,partly-cloudy-night,nan
18,10,8,2017-10-30,rain,nan
210,111,99,2017-11-01,clear-night,nan
1165,684,481,2017-11-03,clear-day,nan
16,11,5,2017-10-06,partly-cloudy-night,nan
399,205,194,2017-10-15,partly-cloudy-day,nan
608,307,301,2018-01-20,clear-night,nan
0,0,0,2017-12-16,clear-night,nan
1436,490,946,2017-11-24,clear-night,Black Friday
119,47,72,2017-11-23,clear-day,Thanksgiving Day
12,4,8,2017-12-31,clear-night,New Year's Eve
479,294,185,2017-12-05,partly-cloudy-night,nan
1289,598,691,2017-11-30,partly-cloudy-day,nan
261,121,140,2018-01-15,clear-night,Martin Luther King Jr. Day
353,228,125,2018-01-12,rain,nan
126,60,66,2017-12-16,clear-day,nan
611,334,277,2018-01-29,partly-cloudy-day,nan
86,56,30,2017-11-08,clear-night,nan
335,145,190,2017-10-15,cloudy,nan
2100,914,1186,2017-11-19,partly-cloudy-day,nan
32,24,8,2017-12-23,partly-cloudy-night,nan
328,202,126,2018-01-11,clear-night,nan
2020,918,1102,2017-12-28,clear-day,nan
6,3,3,2017-10-09,partly-cloudy-night,Columbus Day (regional holiday)
172,132,40,2017-11-30,partly-cloudy-night,nan
7,3,4,2017-11-14,clear-night,nan
2,1,1,2017-11-17,partly-cloudy-night,nan
32,27,5,2018-02-04,rain,nan
1757,898,859,2017-11-09,partly-cloudy-day,nan
97,29,68,2018-01-23,rain,nan
10,6,4,2018-01-16,partly-cloudy-night,nan
1,0,1,2018-01-07,clear-night,nan
2280,1199,1081,2017-10-23,partly-cloudy-day,nan
6,2,4,2017-10-20,clear-night,nan
3191,1691,1500,2017-10-07,clear-day,nan
1881,859,1022,2018-01-21,clear-day,nan
640,375,265,2017-12-04,partly-cloudy-day,nan
77,61,16,2018-01-09,clear-night,nan
10,9,1,2017-12-20,clear-night,nan
19,8,11,2017-11-04,clear-night,nan
7,2,5,2018-01-21,clear-night,nan
1580,760,820,2017-11-07,partly-cloudy-day,nan
274,125,149,2017-10-24,partly-cloudy-night,nan
103,97,6,2017-12-15,clear-night,nan
8,3,5,2018-01-22,cloudy,nan
2743,1429,1314,2017-10-27,clear-day,nan
1034,500,534,2017-11-05,cloudy,Daylight Saving Time ends
313,222,91,2017-12-18,partly-cloudy-night,nan
1224,582,642,2017-11-27,clear-day,nan
15,9,6,2018-01-28,partly-cloudy-night,nan
391,227,164,2017-12-30,partly-cloudy-day,nan
0,0,0,2018-01-09,clear-night,nan
176,70,106,2017-11-15,clear-day,nan
12,4,8,2017-12-03,clear-night,nan
453,171,282,2017-10-08,clear-night,nan
481,143,338,2017-10-01,clear-night,nan
257,143,114,2017-11-17,clear-night,nan
61,27,34,2017-11-21,clear-night,nan
479,330,149,2017-12-25,clear-day,Christmas Day
65,29,36,2018-01-15,clear-day,Martin Luther King Jr. Day
96,46,50,2017-11-24,clear-night,Black Friday
19,7,12,2017-12-11,partly-cloudy-night,nan
1580,816,764,2017-10-18,clear-day,nan
92,55,37,2017-11-06,partly-cloudy-night,nan
606,372,234,2017-12-18,cloudy,nan
175,68,107,2018-01-24,cloudy,nan
1814,826,988,2017-12-01,clear-day,nan
155,79,76,2017-10-02,clear-night,nan
23,12,11,2017-12-07,partly-cloudy-night,nan
403,227,176,2017-11-10,clear-day,Veterans Day observed
264,135,129,2017-10-04,clear-night,nan
36,11,25,2018-01-07,partly-cloudy-night,nan
76,50,26,2017-10-26,partly-cloudy-night,nan
5,2,3,2017-11-26,partly-cloudy-night,nan
931,457,474,2017-12-05,partly-cloudy-day,nan
11,6,5,2017-11-12,clear-night,nan
332,165,167,2017-10-12,clear-night,nan
6,2,4,2017-11-02,cloudy,nan
904,432,472,2017-12-12,partly-cloudy-day,nan
98,54,44,2017-11-28,clear-night,nan
713,371,342,2017-11-06,clear-night,nan
358,123,235,2017-10-18,clear-day,nan
800,384,416,2017-11-16,partly-cloudy-day,nan
234,196,38,2018-01-18,clear-night,nan
5,0,5,2018-01-31,clear-night,nan
3059,1706,1353,2017-10-14,partly-cloudy-day,nan
1143,566,577,2017-12-20,partly-cloudy-day,nan
378,225,153,2017-10-07,partly-cloudy-day,nan
241,96,145,2017-12-05,partly-cloudy-day,nan
1331,671,660,2018-02-03,clear-day,nan
12,6,6,2018-01-14,clear-night,nan
489,351,138,2018-01-22,partly-cloudy-night,nan
2088,1024,1064,2017-10-10,clear-day,nan
56,27,29,2017-12-29,clear-night,nan
183,84,99,2017-12-24,clear-day,Christmas Eve
471,241,230,2017-12-08,clear-day,nan
17,10,7,2017-10-13,clear-night,nan
156,138,18,2017-12-13,partly-cloudy-night,nan
1923,953,970,2017-10-19,clear-day,nan
23,11,12,2018-01-04,partly-cloudy-night,nan
796,332,464,2017-12-15,partly-cloudy-day,nan
53,36,17,2017-12-02,clear-night,nan
616,341,275,2017-10-03,clear-day,nan
649,282,367,2018-02-02,partly-cloudy-day,nan
5,4,1,2017-10-14,partly-cloudy-night,nan
556,285,271,2017-11-26,clear-night,nan
368,264,104,2017-12-21,partly-cloudy-night,nan
106,68,38,2017-10-04,clear-night,nan
2,1,1,2017-12-18,partly-cloudy-night,nan
4,1,3,2017-12-14,partly-cloudy-night,nan
323,154,169,2018-01-27,clear-night,nan
727,330,397,2018-01-08,partly-cloudy-day,nan
1005,467,538,2018-01-14,clear-day,nan
284,199,85,2017-11-15,partly-cloudy-night,nan
143,80,63,2017-10-11,partly-cloudy-night,nan
355,129,226,2017-11-21,clear-day,nan
145,112,33,2017-12-16,partly-cloudy-night,nan
19,13,6,2017-10-02,clear-night,nan
85,53,32,2018-01-26,clear-night,nan
187,61,126,2018-01-11,partly-cloudy-day,nan
899,472,427,2017-12-23,partly-cloudy-day,nan
358,203,155,2017-12-30,clear-night,nan
2066,1125,941,2018-01-01,clear-day,New Year's Day
29,12,17,2017-10-10,partly-cloudy-night,nan
47,38,9,2017-12-02,clear-night,nan
61,48,13,2018-01-31,clear-night,nan
1,0,1,2018-01-02,clear-night,nan
43,21,22,2017-11-28,clear-night,nan
567,218,349,2017-10-20,clear-night,nan
1473,714,759,2017-11-08,partly-cloudy-day,nan
4,1,3,2018-01-18,partly-cloudy-night,nan
6,5,1,2017-12-21,clear-night,nan
3022,1533,1489,2017-10-21,clear-day,nan
665,213,452,2017-10-07,clear-night,nan
11,7,4,2017-12-01,partly-cloudy-night,nan
44,24,20,2017-11-24,clear-night,Black Friday
1499,720,779,2017-11-01,cloudy,nan
170,70,100,2017-12-09,partly-cloudy-day,nan
370,200,170,2018-01-25,clear-day,nan
41,19,22,2018-01-05,clear-night,nan
757,414,343,2017-12-11,clear-day,nan
1802,906,896,2017-12-24,clear-day,Christmas Eve
240,139,101,2017-11-02,clear-night,nan
1296,553,743,2017-12-27,clear-night,nan
826,386,440,2017-12-15,clear-day,nan
882,335,547,2017-10-08,partly-cloudy-day,nan
635,327,308,2017-11-30,clear-day,nan
1,0,1,2017-12-27,clear-night,nan
2217,1121,1096,2017-10-25,partly-cloudy-day,nan
18,8,10,2017-11-27,clear-night,nan
47,35,12,2018-02-02,clear-night,nan
1738,931,807,2017-10-19,clear-day,nan
1818,864,954,2017-12-19,clear-day,nan
36,26,10,2018-01-24,clear-night,nan
120,51,69,2017-11-13,partly-cloudy-day,nan
5,4,1,2017-11-16,partly-cloudy-night,nan
871,404,467,2018-01-29,partly-cloudy-day,nan
31,20,11,2017-12-08,partly-cloudy-night,nan
1503,1300,203,2017-10-14,partly-cloudy-day,nan
102,73,29,2018-01-11,clear-night,nan
1723,889,834,2017-10-16,clear-day,nan
8,4,4,2018-01-03,clear-night,nan
374,211,163,2018-01-19,clear-day,nan
7,5,2,2017-11-29,clear-night,nan
2,1,1,2018-01-11,partly-cloudy-night,nan
1,0,1,2018-01-02,clear-night,nan
64,38,26,2017-10-26,clear-night,nan
3195,1380,1815,2017-11-25,clear-day,nan
368,175,193,2017-10-09,partly-cloudy-night,Columbus Day (regional holiday)
193,89,104,2017-10-27,clear-night,nan
1572,770,802,2017-10-11,clear-day,nan
31,14,17,2018-01-29,clear-night,nan
8,6,2,2017-12-10,partly-cloudy-night,nan
21,16,5,2017-10-21,clear-night,nan
306,128,178,2017-11-17,clear-day,nan
1187,488,699,2017-11-04,clear-night,nan
811,452,359,2017-12-17,cloudy,nan
1735,728,1007,2017-12-17,clear-day,nan
1222,710,512,2017-12-28,clear-day,nan
1081,640,441,2017-10-05,clear-day,nan
141,65,76,2017-10-10,clear-night,nan
1,0,1,2017-12-16,clear-night,nan
55,33,22,2018-01-30,partly-cloudy-night,nan
657,359,298,2017-12-22,partly-cloudy-day,nan
22,11,11,2017-10-06,partly-cloudy-night,nan
2355,1392,963,2017-10-22,clear-day,nan
139,81,58,2017-11-17,clear-night,nan
5,4,1,2017-11-09,clear-night,nan
71,36,35,2018-01-04,snow,nan
1263,595,668,2017-11-27,clear-day,nan
1973,905,1068,2017-11-12,partly-cloudy-day,nan
2420,1356,1064,2017-10-15,partly-cloudy-day,nan
121,57,64,2017-10-24,partly-cloudy-night,nan
56,30,26,2018-01-02,clear-night,nan
59,38,21,2017-12-09,partly-cloudy-night,nan
120,86,34,2018-01-14,clear-night,nan
674,361,313,2017-12-24,partly-cloudy-night,Christmas Eve
1739,791,948,2017-12-21,clear-day,nan
674,340,334,2018-01-15,partly-cloudy-day,Martin Luther King Jr. Day
2369,1181,1188,2017-11-03,partly-cloudy-day,nan
1709,899,810,2017-10-04,clear-day,nan
43,39,4,2017-12-05,rain,nan
2298,1033,1265,2017-10-15,cloudy,nan
34,21,13,2018-01-06,clear-night,nan
71,42,29,2017-11-10,partly-cloudy-night,Veterans Day observed
626,322,304,2018-01-24,partly-cloudy-night,nan
56,36,20,2017-11-19,partly-cloudy-day,nan
1076,552,524,2017-11-23,clear-day,Thanksgiving Day
364,221,143,2017-12-26,clear-day,nan
322,220,102,2017-11-13,clear-night,nan
10,9,1,2017-11-04,clear-night,nan
17,9,8,2017-12-24,clear-night,Christmas Eve
23,13,10,2017-11-07,rain,nan
84,48,36,2017-10-21,clear-night,nan
4,2,2,2017-10-26,partly-cloudy-night,nan
1254,604,650,2018-01-13,partly-cloudy-day,nan
116,70,46,2017-11-10,clear-night,Veterans Day observed
108,67,41,2017-11-01,partly-cloudy-night,nan
642,304,338,2018-02-01,partly-cloudy-day,nan
10,5,5,2017-10-07,clear-night,nan
296,175,121,2017-12-16,cloudy,nan
547,234,313,2017-12-25,clear-night,Christmas Day
378,189,189,2017-11-18,partly-cloudy-night,nan
1543,786,757,2017-10-17,clear-day,nan
82,37,45,2017-10-29,rain,nan
943,458,485,2018-01-07,clear-day,nan
885,400,485,2018-01-10,clear-day,nan
254,89,165,2017-12-20,clear-day,nan
485,284,201,2017-11-27,clear-day,nan
1780,957,823,2017-10-12,partly-cloudy-day,nan
2,1,1,2018-01-18,clear-night,nan
17,9,8,2018-01-27,clear-night,nan
53,51,2,2018-01-04,partly-cloudy-night,nan
1,0,1,2018-01-28,partly-cloudy-night,nan
1650,794,856,2017-11-20,clear-day,nan
1572,792,780,2017-10-03,partly-cloudy-day,nan
1650,994,656,2017-10-27,clear-day,nan
40,25,15,2017-12-19,partly-cloudy-night,nan
1424,659,765,2017-11-06,partly-cloudy-day,nan
9,5,4,2017-10-29,rain,nan
7,5,2,2017-12-31,clear-night,New Year's Eve
2398,1137,1261,2017-10-31,clear-day,Halloween
24,16,8,2017-10-10,clear-night,nan
172,74,98,2017-11-30,clear-night,nan
308,187,121,2018-01-12,cloudy,nan
17,11,6,2017-10-13,partly-cloudy-night,nan
344,0,0,2017-11-09,partly-cloudy-night,nan
1,1,0,2017-11-06,partly-cloudy-night,nan
1826,773,1053,2017-12-18,partly-cloudy-day,nan
0,0,0,2018-01-14,clear-night,nan
115,82,33,2017-12-14,clear-night,nan
1116,518,598,2017-11-14,cloudy,nan
934,421,513,2018-02-04,partly-cloudy-day,nan
571,333,238,2018-01-14,clear-day,nan
264,134,130,2017-10-19,clear-night,nan
1035,479,556,2017-11-16,partly-cloudy-day,nan
1941,1049,892,2017-10-06,clear-day,nan
1545,608,937,2017-12-07,clear-day,nan
8,1,7,2018-01-10,clear-night,nan
62,38,24,2017-11-02,partly-cloudy-night,nan
119,60,59,2018-01-07,clear-night,nan
0,0,0,2018-02-02,rain,nan
2,1,1,2017-11-28,clear-night,nan
818,357,461,2018-01-24,partly-cloudy-day,nan
1668,863,805,2017-10-17,clear-day,nan
1869,746,1123,2017-12-03,partly-cloudy-day,nan
8,6,2,2017-12-29,clear-night,nan
1907,1135,772,2017-10-04,clear-day,nan
170,84,86,2017-11-26,clear-night,nan
1862,906,956,2017-10-06,clear-day,nan
3486,1925,1561,2017-10-28,clear-day,nan
241,132,109,2017-12-23,rain,nan
2209,987,1222,2017-11-11,clear-day,Veterans Day
7,6,1,2018-01-26,partly-cloudy-night,nan
1004,626,378,2018-01-02,clear-day,nan
5,3,2,2017-10-18,clear-night,nan
21,11,10,2017-11-26,partly-cloudy-night,nan
1,0,1,2017-11-11,clear-night,Veterans Day
712,324,388,2018-01-25,clear-day,nan
13,5,8,2018-01-04,partly-cloudy-night,nan
30,18,12,2018-01-18,clear-night,nan
773,393,380,2017-11-29,clear-night,nan
393,180,213,2017-10-05,partly-cloudy-night,nan
2588,1399,1189,2017-12-27,clear-day,nan
484,259,225,2018-01-23,partly-cloudy-day,nan
8,6,2,2017-10-11,clear-night,nan
1193,478,715,2017-11-28,clear-day,nan
116,84,32,2017-12-20,clear-night,nan
353,184,169,2017-10-18,clear-night,nan
7,3,4,2017-11-20,partly-cloudy-night,nan
83,50,33,2018-01-25,clear-night,nan
845,366,479,2018-02-01,clear-day,nan
30,17,13,2017-10-01,partly-cloudy-night,nan
1186,579,607,2017-12-06,clear-day,nan
36,20,16,2017-11-16,partly-cloudy-night,nan
539,221,318,2017-12-10,partly-cloudy-night,nan
800,462,338,2017-11-21,clear-night,nan
15,7,8,2017-10-12,partly-cloudy-night,nan
700,468,232,2017-11-05,partly-cloudy-day,Daylight Saving Time ends
577,261,316,2018-01-08,partly-cloudy-day,nan
564,247,317,2017-12-29,clear-night,nan
710,431,279,2017-12-03,partly-cloudy-day,nan
25,16,9,2017-10-22,clear-night,nan
105,54,51,2017-10-22,clear-night,nan
65,24,41,2017-10-14,partly-cloudy-night,nan
11,7,4,2017-10-04,clear-night,nan
45,20,25,2018-01-22,partly-cloudy-night,nan
172,94,78,2017-12-31,clear-night,New Year's Eve
1775,832,943,2017-12-10,partly-cloudy-day,nan
654,339,315,2017-10-09,rain,Columbus Day (regional holiday)
325,244,81,2018-01-16,partly-cloudy-night,nan
27,19,8,2018-02-02,partly-cloudy-night,nan
2,0,2,2018-01-29,clear-night,nan
102,49,53,2017-12-22,partly-cloudy-night,nan
5,4,1,2017-12-05,partly-cloudy-night,nan
3,1,2,2018-01-24,clear-night,nan
1995,983,1012,2017-12-17,clear-day,nan
1,0,1,2018-02-01,clear-night,nan
700,311,389,2017-10-13,partly-cloudy-night,nan
289,140,149,2017-12-08,partly-cloudy-night,nan
540,345,195,2017-11-14,partly-cloudy-night,nan
294,225,69,2017-12-06,clear-night,nan
332,255,77,2018-01-30,partly-cloudy-night,nan
60,36,24,2017-12-23,rain,nan
10,6,4,2017-10-13,partly-cloudy-night,nan
828,439,389,2018-02-03,clear-day,nan
89,51,38,2017-11-20,partly-cloudy-night,nan
1913,1162,751,2017-10-10,clear-day,nan
353,176,177,2017-10-19,clear-night,nan
113,88,25,2017-10-01,partly-cloudy-night,nan
353,123,230,2017-11-08,partly-cloudy-day,nan
437,149,288,2017-10-11,clear-day,nan
1666,852,814,2017-10-03,clear-day,nan
225,97,128,2017-10-16,clear-night,nan
287,125,162,2017-10-05,clear-night,nan
387,214,173,2017-10-22,clear-day,nan
113,82,31,2017-11-09,clear-night,nan
304,144,160,2017-10-19,clear-night,nan
11,8,3,2018-01-30,partly-cloudy-night,nan
184,94,90,2017-12-31,clear-night,New Year's Eve
6,4,2,2017-10-29,partly-cloudy-night,nan
5,3,2,2018-01-12,partly-cloudy-night,nan
59,33,26,2017-10-12,partly-cloudy-night,nan
16,9,7,2017-10-23,clear-night,nan
1767,866,901,2017-12-10,clear-day,nan
36,14,22,2018-01-16,cloudy,nan
85,55,30,2017-11-29,clear-night,nan
4055,1560,2495,2017-10-28,clear-day,nan
1075,573,502,2017-10-23,partly-cloudy-day,nan
18,10,8,2017-11-03,clear-night,nan
46,24,22,2018-01-19,clear-night,nan
1485,719,766,2017-11-08,partly-cloudy-day,nan
1611,811,800,2017-10-04,clear-day,nan
1176,625,551,2017-11-24,clear-day,Black Friday
477,254,223,2017-10-09,partly-cloudy-day,Columbus Day (regional holiday)
38,20,18,2017-11-19,partly-cloudy-night,nan
601,331,270,2018-01-07,clear-day,nan
0,0,0,2017-12-30,partly-cloudy-night,nan
37,26,11,2017-11-18,clear-night,nan
1474,780,694,2017-11-01,partly-cloudy-day,nan
16,15,1,2017-12-28,clear-night,nan
878,372,506,2017-11-03,partly-cloudy-night,nan
1014,363,651,2017-11-25,partly-cloudy-night,nan
133,59,74,2017-10-16,clear-night,nan
50,29,21,2017-12-25,rain,Christmas Day
100,64,36,2017-12-01,clear-night,nan
398,273,125,2017-12-19,clear-night,nan
6,4,2,2017-12-11,partly-cloudy-night,nan
6,2,4,2017-12-27,cloudy,nan
77,26,51,2017-12-14,fog,nan
5,4,1,2018-01-23,fog,nan
8,6,2,2017-10-10,clear-night,nan
58,34,24,2017-10-16,partly-cloudy-night,nan
2913,1311,1602,2017-11-24,clear-day,Black Friday
83,44,39,2017-10-23,partly-cloudy-night,nan
15,2,13,2018-01-02,clear-night,nan
258,155,103,2018-01-04,snow,nan
0,0,0,2018-01-05,clear-night,nan
12,9,3,2018-01-19,clear-night,nan
101,54,47,2017-10-05,partly-cloudy-night,nan
332,158,174,2017-12-26,clear-night,nan
1022,414,608,2017-11-14,partly-cloudy-day,nan
256,77,179,2017-12-12,partly-cloudy-day,nan
43,30,13,2018-01-13,cloudy,nan
11,4,7,2018-01-18,clear-night,nan
40,18,22,2018-01-25,clear-night,nan
104,60,44,2018-01-19,clear-night,nan
744,340,404,2017-12-13,clear-day,nan
0,0,0,2018-01-30,partly-cloudy-night,nan
1084,491,593,2017-10-30,clear-night,nan
325,223,102,2017-12-17,partly-cloudy-night,nan
27,12,15,2018-01-08,clear-night,nan
90,47,43,2017-12-25,clear-night,Christmas Day
796,359,437,2018-01-24,partly-cloudy-day,nan
62,32,30,2017-12-23,rain,nan
2,0,2,2017-12-08,clear-night,nan
983,467,516,2017-11-13,partly-cloudy-day,nan
18,8,10,2017-12-12,partly-cloudy-night,nan
84,47,37,2017-11-03,clear-night,nan
722,367,355,2018-02-04,partly-cloudy-day,nan
7,2,5,2017-11-14,clear-night,nan
1581,735,846,2017-11-18,clear-day,nan
3,1,2,2017-11-23,clear-night,Thanksgiving Day
456,207,249,2018-01-10,partly-cloudy-night,nan
321,202,119,2018-01-20,clear-day,nan
61,32,29,2018-01-16,partly-cloudy-night,nan
283,143,140,2017-10-14,partly-cloudy-night,nan
1015,372,643,2018-01-21,partly-cloudy-night,nan
194,91,103,2018-01-03,clear-day,nan
311,186,125,2018-01-09,clear-day,nan
329,234,95,2017-11-27,clear-night,nan
6,4,2,2017-12-19,cloudy,nan
433,335,98,2017-12-11,clear-night,nan
6,4,2,2017-11-07,rain,nan
300,187,113,2017-11-09,partly-cloudy-night,nan
69,39,30,2017-11-20,clear-night,nan
143,80,63,2017-11-07,clear-night,nan
3,2,1,2017-11-01,clear-night,nan
1050,494,556,2017-11-15,clear-day,nan
82,31,51,2018-01-17,snow,nan
2,0,2,2018-01-10,clear-night,nan
80,55,25,2018-01-22,partly-cloudy-night,nan
734,453,281,2017-11-04,clear-day,nan
224,144,80,2017-11-25,partly-cloudy-night,nan
955,407,548,2018-01-15,clear-day,Martin Luther King Jr. Day
102,83,19,2018-01-25,clear-night,nan
1207,473,734,2018-01-02,clear-night,nan
1926,809,1117,2017-11-12,clear-day,nan
1447,921,526,2017-11-02,partly-cloudy-day,nan
280,145,135,2017-11-13,partly-cloudy-day,nan
1532,774,758,2017-11-09,partly-cloudy-day,nan
52,26,26,2018-01-14,clear-night,nan
175,97,78,2017-12-03,partly-cloudy-night,nan
3,1,2,2018-01-17,cloudy,nan
1444,722,722,2017-11-26,partly-cloudy-day,nan
47,38,9,2017-12-05,rain,nan
89,40,49,2018-01-03,clear-night,nan
84,38,46,2017-11-22,partly-cloudy-day,nan
2340,1085,1255,2017-10-13,partly-cloudy-day,nan
242,122,120,2017-10-11,partly-cloudy-night,nan
364,232,132,2017-11-16,clear-night,nan
73,34,39,2017-11-05,cloudy,Daylight Saving Time ends
2649,1426,1223,2017-10-15,partly-cloudy-day,nan
540,274,266,2017-12-05,partly-cloudy-day,nan
181,121,60,2017-11-18,rain,nan
2,0,2,2017-10-02,clear-night,nan
59,40,19,2017-12-09,partly-cloudy-night,nan
59,26,33,2017-12-28,clear-night,nan
1719,885,834,2017-10-02,clear-day,nan
952,437,515,2017-11-20,clear-night,nan
158,96,62,2017-10-25,clear-night,nan
1838,939,899,2017-12-29,clear-day,nan
3388,1644,1744,2017-10-07,clear-day,nan
42,27,15,2018-02-03,partly-cloudy-night,nan
2733,1208,1525,2017-12-02,clear-day,nan
23,8,15,2017-12-12,partly-cloudy-night,nan
7,5,2,2017-11-04,clear-night,nan
677,378,299,2017-10-24,partly-cloudy-day,nan
821,396,425,2017-12-09,partly-cloudy-day,nan
291,91,200,2017-10-17,clear-day,nan
141,113,28,2017-12-01,clear-night,nan
500,271,229,2017-10-13,partly-cloudy-day,nan
134,65,69,2017-10-03,clear-night,nan
593,339,254,2018-02-01,partly-cloudy-day,nan
1861,1062,799,2017-10-18,clear-day,nan
112,38,74,2017-10-09,clear-night,Columbus Day (regional holiday)
46,27,19,2017-10-17,clear-night,nan
2,1,1,2017-10-29,rain,nan
91,54,37,2017-10-27,clear-night,nan
169,82,87,2018-01-31,clear-day,nan
326,176,150,2018-01-17,snow,nan
223,112,111,2017-10-18,clear-night,nan
10,8,2,2017-12-16,clear-night,nan
1239,762,477,2017-10-12,partly-cloudy-day,nan
316,141,175,2017-11-02,partly-cloudy-night,nan
275,117,158,2017-10-01,clear-night,nan
1333,612,721,2017-12-07,clear-day,nan
2305,1254,1051,2017-12-29,partly-cloudy-day,nan
3,0,3,2017-11-27,clear-night,nan
2124,1188,936,2017-10-06,clear-day,nan
2487,1282,1205,2017-12-24,clear-day,Christmas Eve
373,150,223,2017-10-07,clear-night,nan
321,183,138,2018-02-02,clear-day,nan
87,46,41,2017-11-03,clear-night,nan
143,64,79,2017-12-28,clear-night,nan
487,281,206,2018-01-29,clear-day,nan
1109,513,596,2018-01-09,clear-day,nan
796,411,385,2017-10-31,clear-day,Halloween
85,48,37,2018-01-14,clear-day,nan
83,32,51,2018-01-08,cloudy,nan
536,293,243,2017-10-02,clear-day,nan
1966,808,1158,2017-11-21,clear-day,nan
115,89,26,2017-12-23,partly-cloudy-night,nan
1210,643,567,2017-12-18,cloudy,nan
13,8,5,2017-12-05,partly-cloudy-night,nan
56,28,28,2018-02-01,partly-cloudy-night,nan
395,150,245,2017-10-04,clear-night,nan
208,85,123,2017-11-29,clear-night,nan
5,3,2,2017-11-08,partly-cloudy-night,nan
1994,1023,971,2017-10-20,clear-day,nan
60,37,23,2018-01-10,partly-cloudy-night,nan
1080,511,569,2018-01-11,partly-cloudy-day,nan
394,235,159,2017-12-20,clear-night,nan
2105,1007,1098,2017-10-10,clear-day,nan
173,104,69,2017-11-05,cloudy,Daylight Saving Time ends
60,37,23,2018-01-23,clear-night,nan
1217,636,581,2017-10-24,partly-cloudy-day,nan
14,9,5,2017-10-21,clear-night,nan
697,324,373,2018-01-28,partly-cloudy-day,nan
29,15,14,2017-11-13,clear-night,nan
1576,758,818,2017-10-11,clear-day,nan
1932,815,1117,2017-12-16,partly-cloudy-day,nan
561,394,167,2017-12-06,clear-night,nan
9,5,4,2017-10-09,partly-cloudy-night,Columbus Day (regional holiday)
11,3,8,2017-10-16,partly-cloudy-night,nan
146,66,80,2017-11-26,clear-night,nan
681,299,382,2018-01-18,clear-day,nan
1695,996,699,2017-10-03,clear-day,nan
20,10,10,2018-01-20,clear-night,nan
125,105,20,2017-12-20,clear-night,nan
17,11,6,2017-10-27,clear-night,nan
260,145,115,2018-01-10,clear-day,nan
8,6,2,2018-01-12,fog,nan
187,176,11,2017-12-22,partly-cloudy-night,nan
43,21,22,2018-01-15,clear-night,Martin Luther King Jr. Day
1345,713,632,2017-11-06,rain,nan
1242,549,693,2017-11-05,cloudy,Daylight Saving Time ends
102,66,36,2018-01-19,clear-night,nan
409,257,152,2017-12-04,partly-cloudy-night,nan
0,0,0,2018-01-06,clear-night,nan
329,209,120,2018-01-26,clear-night,nan
7,4,3,2017-10-19,clear-night,nan
855,379,476,2018-01-26,clear-day,nan
21,10,11,2017-10-05,clear-night,nan
2585,1253,1332,2017-10-14,partly-cloudy-day,nan
15,9,6,2017-11-19,partly-cloudy-night,nan
1042,514,528,2018-01-28,partly-cloudy-day,nan
145,71,74,2017-12-21,clear-night,nan
1604,702,902,2017-12-18,partly-cloudy-day,nan
31,9,22,2017-11-24,clear-night,Black Friday
3451,1587,1864,2017-10-28,clear-day,nan
78,41,37,2017-12-10,clear-night,nan
844,411,433,2017-11-30,clear-night,nan
2,0,2,2017-12-26,clear-night,nan
77,44,33,2017-12-15,partly-cloudy-night,nan
1579,736,843,2017-12-07,clear-day,nan
324,170,154,2017-10-25,clear-night,nan
1589,741,848,2017-12-31,clear-day,New Year's Eve
259,184,75,2018-01-17,partly-cloudy-night,nan
1536,566,970,2017-10-22,clear-day,nan
2991,1529,1462,2017-11-04,partly-cloudy-day,nan
4,2,2,2017-11-07,clear-night,nan
204,128,76,2017-12-30,clear-night,nan
89,34,55,2017-11-18,clear-day,nan
26,13,13,2017-10-20,clear-night,nan
1654,782,872,2017-12-16,partly-cloudy-day,nan
687,322,365,2017-12-14,partly-cloudy-day,nan
126,48,78,2017-12-30,clear-night,nan
3209,1666,1543,2017-10-21,clear-day,nan
1025,583,442,2017-11-20,partly-cloudy-day,nan
105,84,21,2017-12-09,partly-cloudy-night,nan
68,24,44,2017-11-14,partly-cloudy-night,nan
380,203,177,2017-11-12,clear-night,nan
14,7,7,2018-01-05,clear-night,nan
2,1,1,2018-01-01,clear-night,New Year's Day
1621,744,877,2017-11-01,partly-cloudy-day,nan
1,0,1,2018-02-04,cloudy,nan
280,118,162,2018-01-06,clear-night,nan
598,340,258,2017-10-29,rain,nan
369,206,163,2017-11-19,partly-cloudy-night,nan
4,1,3,2018-01-01,clear-night,New Year's Day
1231,560,671,2017-11-28,clear-day,nan
2,0,2,2018-01-15,clear-night,Martin Luther King Jr. Day
651,342,309,2018-01-06,clear-day,nan
124,67,57,2018-01-05,clear-day,nan
78,45,33,2017-10-23,partly-cloudy-night,nan
31,17,14,2017-11-17,partly-cloudy-night,nan
69,51,18,2018-01-12,partly-cloudy-night,nan
313,167,146,2017-11-23,clear-day,Thanksgiving Day
7,5,2,2018-01-23,fog,nan
11,7,4,2017-12-08,clear-night,nan
35,15,20,2017-11-28,clear-night,nan
154,54,100,2018-01-01,clear-night,New Year's Day
16,5,11,2017-12-28,clear-night,nan
228,82,146,2017-11-23,clear-night,Thanksgiving Day
2234,1207,1027,2017-10-30,partly-cloudy-day,nan
30,14,16,2017-10-20,clear-night,nan
315,197,118,2018-02-04,partly-cloudy-day,nan
1001,431,570,2017-12-12,partly-cloudy-day,nan
1694,780,914,2017-12-19,clear-day,nan
5,4,1,2017-11-05,partly-cloudy-night,Daylight Saving Time ends
2721,1539,1182,2017-10-14,partly-cloudy-day,nan
1073,444,629,2017-12-05,partly-cloudy-day,nan
1269,587,682,2017-11-10,clear-day,Veterans Day observed
260,108,152,2018-01-24,partly-cloudy-day,nan
7,4,3,2017-11-12,clear-night,nan
926,392,534,2018-01-19,clear-day,nan
211,112,99,2017-10-12,partly-cloudy-night,nan
490,190,300,2017-10-10,clear-day,nan
4,3,1,2017-11-16,partly-cloudy-night,nan
593,327,266,2017-11-28,clear-day,nan
1717,715,1002,2017-11-26,clear-day,nan
1969,947,1022,2018-01-02,clear-day,nan
48,38,10,2017-11-26,clear-night,nan
1481,699,782,2017-12-20,clear-day,nan
3046,1596,1450,2017-10-22,clear-day,nan
292,114,178,2017-12-06,partly-cloudy-day,nan
60,36,24,2017-10-31,clear-night,Halloween
52,28,24,2018-01-04,partly-cloudy-night,nan
10,5,5,2017-10-25,partly-cloudy-night,nan
3,2,1,2017-10-30,clear-night,nan
396,191,205,2017-11-15,clear-day,nan
12,5,7,2018-01-13,partly-cloudy-night,nan
1099,654,445,2017-11-21,clear-day,nan
19,13,6,2017-12-04,partly-cloudy-night,nan
1825,914,911,2017-12-22,partly-cloudy-day,nan
887,477,410,2017-11-06,partly-cloudy-day,nan
119,58,61,2017-12-29,clear-night,nan
184,98,86,2018-01-27,clear-day,nan
1844,881,963,2017-11-17,clear-day,nan
2,1,1,2017-12-28,clear-night,nan
463,230,233,2017-12-13,partly-cloudy-day,nan
238,145,93,2018-01-13,clear-night,nan
2115,1016,1099,2017-12-27,clear-day,nan
57,29,28,2017-11-22,clear-night,nan
7,3,4,2017-12-17,partly-cloudy-night,nan
163,132,31,2017-12-13,clear-night,nan
928,529,399,2017-11-22,rain,nan
420,312,108,2018-01-31,clear-night,nan
616,279,337,2018-02-02,partly-cloudy-day,nan
15,12,3,2017-10-14,partly-cloudy-night,nan
1,0,1,2018-01-08,partly-cloudy-night,nan
14,8,6,2017-10-28,clear-night,nan
1721,801,920,2017-11-09,partly-cloudy-day,nan
657,317,340,2018-01-25,clear-day,nan
128,63,65,2017-12-03,clear-night,nan
214,111,103,2017-12-14,clear-night,nan
521,320,201,2017-11-12,clear-day,nan
370,188,182,2017-12-21,clear-day,nan
143,75,68,2018-01-20,clear-night,nan
0,0,0,2017-12-15,clear-night,nan
2983,1591,1392,2017-10-07,clear-day,nan
1520,757,763,2017-10-26,partly-cloudy-day,nan
823,412,411,2018-01-29,partly-cloudy-day,nan
398,198,200,2018-01-27,clear-day,nan
302,159,143,2017-11-25,clear-day,nan
18,6,12,2018-01-07,clear-night,nan
165,75,90,2017-11-27,clear-night,nan
135,92,43,2018-02-01,partly-cloudy-night,nan
848,469,379,2017-11-16,clear-night,nan
206,97,109,2018-01-16,partly-cloudy-day,nan
283,90,193,2017-11-14,partly-cloudy-day,nan
55,26,29,2017-11-16,rain,nan
125,60,65,2018-01-21,partly-cloudy-night,nan
7,6,1,2017-12-22,clear-night,nan
1,0,1,2017-11-21,clear-night,nan
147,66,81,2017-12-17,partly-cloudy-day,nan
24,14,10,2017-10-31,clear-night,Halloween
101,78,23,2017-11-10,clear-night,Veterans Day observed
490,197,293,2017-10-17,clear-night,nan
2,0,2,2018-01-21,clear-night,nan
1305,698,607,2017-12-02,clear-day,nan
845,504,341,2017-10-01,clear-day,nan
0,0,0,2017-12-06,partly-cloudy-night,nan
27,20,7,2018-01-21,clear-night,nan
399,179,220,2017-11-29,partly-cloudy-day,nan
1083,495,588,2017-11-15,partly-cloudy-day,nan
589,224,365,2017-10-08,partly-cloudy-night,nan
1433,620,813,2018-01-13,clear-day,nan
505,295,210,2017-12-09,fog,nan
8,3,5,2017-12-04,partly-cloudy-night,nan
141,67,74,2017-11-11,clear-night,Veterans Day
2,0,2,2017-10-17,clear-night,nan
50,29,21,2017-12-18,partly-cloudy-night,nan
725,333,392,2018-01-22,partly-cloudy-day,nan
769,394,375,2018-01-18,clear-day,nan
22,14,8,2017-10-03,clear-night,nan
917,527,390,2017-11-17,clear-day,nan
719,374,345,2018-01-22,clear-day,nan
1728,840,888,2017-12-11,clear-day,nan
474,195,279,2017-10-15,cloudy,nan
11,8,3,2018-01-28,partly-cloudy-night,nan
681,253,428,2018-01-14,clear-night,nan
57,38,19,2017-10-08,clear-night,nan
2271,1355,916,2017-10-25,partly-cloudy-day,nan
364,152,212,2017-10-06,clear-night,nan
19,10,9,2017-11-06,partly-cloudy-night,nan
1258,716,542,2017-10-26,partly-cloudy-day,nan
5,4,1,2017-12-13,clear-night,nan
1957,965,992,2017-11-02,clear-day,nan
45,27,18,2018-01-18,clear-night,nan
1652,936,716,2017-10-18,clear-day,nan
1066,505,561,2017-11-16,clear-day,nan
1734,798,936,2018-01-03,clear-day,nan
849,325,524,2017-10-21,clear-night,nan
1,0,1,2018-02-03,clear-night,nan
2,1,1,2017-11-11,clear-night,Veterans Day
514,309,205,2018-02-03,clear-night,nan
476,248,228,2017-11-05,partly-cloudy-night,Daylight Saving Time ends
17,9,8,2017-11-28,clear-night,nan
1726,850,876,2017-10-05,clear-day,nan
2962,1445,1517,2017-10-14,cloudy,nan
168,75,93,2017-12-05,partly-cloudy-night,nan
2140,1102,1038,2017-10-20,clear-day,nan
1744,944,800,2017-10-11,partly-cloudy-day,nan
869,454,415,2018-01-11,partly-cloudy-day,nan
17,8,9,2017-12-02,clear-night,nan
710,355,355,2018-01-25,clear-day,nan
5,3,2,2017-12-10,partly-cloudy-night,nan
206,128,78,2017-11-06,clear-night,nan
704,465,239,2017-11-25,clear-day,nan
190,106,84,2017-11-18,clear-day,nan
138,63,75,2018-01-28,partly-cloudy-night,nan
243,144,99,2017-11-12,clear-night,nan
9,5,4,2017-11-15,partly-cloudy-night,nan
95,54,41,2017-12-24,clear-night,Christmas Eve
382,189,193,2017-10-21,clear-day,nan
1051,403,648,2017-11-26,clear-night,nan
7,3,4,2017-10-06,clear-night,nan
307,235,72,2017-12-21,clear-night,nan
111,90,21,2017-12-20,clear-night,nan
683,401,282,2017-10-10,clear-day,nan
9,5,4,2017-12-09,partly-cloudy-night,nan
4,2,2,2018-02-03,clear-night,nan
87,46,41,2018-01-05,clear-night,nan
23,11,12,2017-10-15,partly-cloudy-night,nan
184,104,80,2017-11-23,clear-night,Thanksgiving Day
165,99,66,2017-11-08,partly-cloudy-night,nan
16,9,7,2017-10-04,clear-night,nan
10,9,1,2017-10-24,partly-cloudy-night,nan
522,254,268,2017-11-01,cloudy,nan
510,204,306,2018-01-15,clear-night,Martin Luther King Jr. Day
38,25,13,2018-01-26,clear-night,nan
23,16,7,2017-11-19,rain,nan
953,469,484,2017-12-12,partly-cloudy-day,nan
41,15,26,2017-10-09,partly-cloudy-night,Columbus Day (regional holiday)
241,171,70,2017-11-30,partly-cloudy-night,nan
766,366,400,2017-10-23,partly-cloudy-day,nan
393,187,206,2017-10-28,partly-cloudy-night,nan
526,277,249,2018-01-28,partly-cloudy-day,nan
1546,767,779,2017-11-07,partly-cloudy-day,nan
186,67,119,2017-10-29,rain,nan
151,105,46,2018-01-09,clear-night,nan
369,259,110,2017-11-14,partly-cloudy-night,nan
361,160,201,2017-10-20,clear-night,nan
356,130,226,2017-11-29,partly-cloudy-day,nan
56,19,37,2018-01-05,clear-day,nan
607,328,279,2018-02-03,clear-day,nan
137,60,77,2018-01-11,partly-cloudy-night,nan
2623,1220,1403,2017-12-26,clear-day,nan
1457,621,836,2017-10-27,clear-night,nan
69,30,39,2017-11-28,clear-night,nan
2495,1452,1043,2017-12-25,partly-cloudy-day,Christmas Day
1964,890,1074,2017-12-31,clear-day,New Year's Eve
162,82,80,2018-01-02,clear-day,nan
148,75,73,2017-10-22,clear-night,nan
361,186,175,2017-12-16,cloudy,nan
2753,1372,1381,2017-10-27,clear-day,nan
12,10,2,2017-12-06,rain,nan
220,135,85,2017-12-10,clear-night,nan
945,568,377,2017-10-21,clear-day,nan
38,21,17,2018-01-17,partly-cloudy-night,nan
137,71,66,2018-02-04,partly-cloudy-day,nan
877,436,441,2017-12-20,clear-night,nan
490,233,257,2017-12-15,snow,nan
936,449,487,2017-12-14,partly-cloudy-day,nan
1321,726,595,2017-12-30,fog,nan
1490,697,793,2017-11-20,clear-day,nan
22,2,20,2018-01-06,clear-night,nan
132,58,74,2017-12-27,clear-night,nan
57,20,37,2017-12-24,cloudy,Christmas Eve
83,47,36,2017-11-30,clear-night,nan
56,22,34,2018-01-15,partly-cloudy-night,Martin Luther King Jr. Day
234,128,106,2017-11-12,clear-day,nan
162,75,87,2017-11-20,partly-cloudy-day,nan
2277,1149,1128,2017-10-25,partly-cloudy-day,nan
114,56,58,2017-12-26,clear-night,nan
6,2,4,2018-01-20,clear-night,nan
1019,513,506,2017-12-18,partly-cloudy-night,nan
1679,753,926,2017-12-08,clear-day,nan
1,0,1,2017-12-07,clear-night,nan
1,0,1,2018-02-02,rain,nan
21,10,11,2018-01-12,partly-cloudy-night,nan
225,101,124,2018-01-19,clear-day,nan
75,52,23,2017-10-29,partly-cloudy-night,nan
79,33,46,2017-11-13,partly-cloudy-day,nan
823,417,406,2017-11-10,clear-day,Veterans Day observed
735,337,398,2018-01-05,clear-day,nan
21,6,15,2017-11-18,clear-night,nan
539,238,301,2017-10-23,partly-cloudy-night,nan
731,388,343,2017-12-12,partly-cloudy-day,nan
250,125,125,2017-10-09,partly-cloudy-night,Columbus Day (regional holiday)
911,581,330,2017-10-30,partly-cloudy-day,nan
66,43,23,2018-01-24,clear-night,nan
41,15,26,2017-10-05,clear-night,nan
3,1,2,2017-11-29,clear-night,nan
109,69,40,2017-10-26,clear-night,nan
251,123,128,2017-11-04,clear-night,nan
3,2,1,2017-12-16,clear-night,nan
641,285,356,2018-02-01,partly-cloudy-day,nan
1,0,1,2017-11-25,clear-night,nan
8,3,5,2018-01-04,partly-cloudy-night,nan
130,78,52,2018-01-13,partly-cloudy-day,nan
480,252,228,2017-10-17,clear-day,nan
513,242,271,2017-11-16,partly-cloudy-day,nan
139,76,63,2017-10-27,clear-night,nan
12,5,7,2017-12-14,partly-cloudy-night,nan
1603,738,865,2017-11-22,partly-cloudy-day,nan
2065,878,1187,2017-11-11,clear-day,Veterans Day
4,2,2,2018-01-11,partly-cloudy-night,nan
5,4,1,2018-01-31,clear-night,nan
2005,937,1068,2017-12-28,clear-day,nan
2,0,2,2017-12-06,partly-cloudy-night,nan
383,232,151,2017-11-15,partly-cloudy-night,nan
13,7,6,2017-11-11,clear-night,Veterans Day
5,4,1,2017-10-30,rain,nan
2679,1516,1163,2017-10-22,clear-day,nan
129,60,69,2017-11-17,clear-night,nan
1842,822,1020,2017-12-01,clear-day,nan
14,7,7,2017-11-22,clear-night,nan
46,39,7,2018-01-13,clear-night,nan
1214,606,608,2018-01-14,clear-day,nan
24,7,17,2017-11-24,clear-night,Black Friday
1287,516,771,2018-01-20,clear-night,nan
962,458,504,2017-11-30,partly-cloudy-day,nan
818,356,462,2017-10-31,clear-night,Halloween
8,3,5,2018-01-05,partly-cloudy-night,nan
671,303,368,2017-12-03,partly-cloudy-night,nan
3,2,1,2017-12-04,clear-night,nan
2,1,1,2018-01-27,clear-night,nan
1179,561,618,2017-11-30,partly-cloudy-day,nan
1333,575,758,2017-11-27,clear-day,nan
193,130,63,2018-01-12,rain,nan
2127,998,1129,2018-01-27,clear-day,nan
12,7,5,2018-01-17,cloudy,nan
463,275,188,2017-11-22,partly-cloudy-night,nan
1215,482,733,2017-12-29,clear-night,nan
128,69,59,2018-01-29,partly-cloudy-night,nan
502,268,234,2018-01-08,clear-day,nan
74,43,31,2017-12-16,clear-night,nan
189,84,105,2017-11-21,clear-day,nan
8,5,3,2017-11-17,clear-night,nan
49,37,12,2017-10-28,clear-night,nan
942,505,437,2017-12-09,fog,nan
36,20,16,2017-12-22,partly-cloudy-night,nan
1768,841,927,2017-12-04,clear-day,nan
466,260,206,2018-01-27,partly-cloudy-night,nan
1593,783,810,2018-01-02,clear-day,nan
5,3,2,2018-01-07,clear-night,nan
1992,846,1146,2017-11-19,partly-cloudy-day,nan
1374,612,762,2017-12-20,partly-cloudy-day,nan
631,292,339,2018-01-16,partly-cloudy-day,nan
701,303,398,2018-01-11,partly-cloudy-night,nan
0,0,0,2017-11-14,clear-night,nan
463,299,164,2017-11-13,partly-cloudy-night,nan
23,12,11,2017-10-20,clear-night,nan
35,25,10,2017-11-11,clear-night,Veterans Day
24,15,9,2017-10-08,partly-cloudy-night,nan
1,1,0,2017-11-07,rain,nan
249,149,100,2018-01-13,partly-cloudy-day,nan
755,446,309,2017-12-23,rain,nan
16,13,3,2018-01-13,partly-cloudy-night,nan
3,2,1,2017-10-31,clear-night,Halloween
14,8,6,2018-01-15,clear-night,Martin Luther King Jr. Day
95,83,12,2017-12-14,clear-night,nan
2616,1447,1169,2017-10-01,clear-day,nan
7,4,3,2017-12-21,clear-night,nan
660,386,274,2017-10-06,clear-day,nan
1607,802,805,2017-12-22,partly-cloudy-day,nan
659,329,330,2017-11-11,clear-night,Veterans Day
2,1,1,2017-12-17,partly-cloudy-night,nan
10,6,4,2018-01-26,clear-night,nan
2,1,1,2017-12-18,cloudy,nan
1237,816,421,2017-10-24,partly-cloudy-day,nan
1125,492,633,2017-11-29,clear-day,nan
4,3,1,2018-01-28,rain,nan
81,45,36,2018-01-24,cloudy,nan
2248,1158,1090,2017-12-25,partly-cloudy-day,Christmas Day
217,111,106,2018-01-12,cloudy,nan
1340,611,729,2017-12-06,clear-day,nan
364,207,157,2018-01-21,clear-day,nan
200,147,53,2017-11-21,clear-night,nan
1264,644,620,2017-12-11,clear-day,nan
1376,626,750,2017-12-11,clear-day,nan
1224,666,558,2017-12-22,partly-cloudy-day,nan
1952,1072,880,2017-10-02,clear-day,nan
1960,981,979,2017-11-02,partly-cloudy-day,nan
3,1,2,2018-02-03,clear-night,nan
2160,982,1178,2018-01-03,clear-day,nan
2,0,2,2017-12-29,partly-cloudy-night,nan
1489,808,681,2017-10-16,clear-day,nan
155,109,46,2018-01-23,clear-night,nan
201,115,86,2017-10-21,clear-night,nan
22,12,10,2017-10-26,partly-cloudy-night,nan
94,48,46,2017-12-13,clear-night,nan
9,7,2,2017-11-28,clear-night,nan
335,221,114,2017-12-07,clear-night,nan
214,101,113,2018-01-07,clear-night,nan
1995,886,1109,2017-12-03,partly-cloudy-day,nan
1989,941,1048,2017-10-06,clear-day,nan
2754,1256,1498,2017-11-25,clear-day,nan
340,221,119,2018-01-18,clear-night,nan
323,172,151,2018-01-23,rain,nan
508,335,173,2017-11-29,clear-night,nan
16,11,5,2017-10-04,clear-night,nan
459,276,183,2017-12-17,partly-cloudy-day,nan
493,242,251,2017-10-06,clear-day,nan
226,122,104,2017-10-15,partly-cloudy-night,nan
308,141,167,2017-10-10,clear-night,nan
184,148,36,2017-12-22,cloudy,nan
2,0,2,2018-01-25,clear-night,nan
161,69,92,2017-11-24,clear-night,Black Friday
687,392,295,2017-10-05,clear-day,nan
8,8,0,2017-10-11,clear-night,nan
29,14,15,2018-01-30,clear-night,nan
11,4,7,2017-11-20,partly-cloudy-night,nan
35,12,23,2017-11-03,clear-night,nan
25,13,12,2017-10-01,partly-cloudy-night,nan
241,116,125,2017-12-31,clear-night,New Year's Eve
1260,549,711,2017-12-15,partly-cloudy-day,nan
93,51,42,2017-11-15,partly-cloudy-night,nan
4,2,2,2017-11-09,clear-night,nan
1282,509,773,2017-11-21,clear-night,nan
6,3,3,2017-10-12,partly-cloudy-night,nan
1663,721,942,2018-01-21,clear-day,nan
3,2,1,2018-01-15,clear-night,Martin Luther King Jr. Day
14,6,8,2018-01-24,clear-night,nan
670,380,290,2017-10-27,clear-day,nan
4,2,2,2017-12-14,partly-cloudy-night,nan
60,25,35,2017-10-16,partly-cloudy-night,nan
1328,163,1165,2018-01-01,clear-night,New Year's Day
2287,1137,1150,2017-11-03,clear-day,nan
422,192,230,2017-10-09,rain,Columbus Day (regional holiday)
0,0,0,2017-12-25,cloudy,Christmas Day
2,1,1,2017-10-22,clear-night,nan
144,57,87,2017-10-13,partly-cloudy-night,nan
2210,1148,1062,2017-12-10,partly-cloudy-day,nan
10,4,6,2018-01-29,clear-night,nan
545,266,279,2017-11-08,partly-cloudy-day,nan
2137,1085,1052,2017-10-23,clear-day,nan
4,0,4,2017-12-05,partly-cloudy-night,nan
951,575,376,2017-10-28,clear-day,nan
1183,565,618,2017-12-25,partly-cloudy-night,Christmas Day
160,87,73,2017-11-01,clear-night,nan
248,86,162,2017-12-11,partly-cloudy-day,nan
161,115,46,2017-12-16,partly-cloudy-night,nan
59,32,27,2017-11-13,clear-night,nan
1856,840,1016,2017-12-26,clear-day,nan
221,125,96,2018-01-23,partly-cloudy-day,nan
197,120,77,2017-11-18,rain,nan
535,310,225,2018-02-01,clear-day,nan
2142,1113,1029,2017-11-23,clear-day,Thanksgiving Day
1388,709,679,2017-10-17,clear-day,nan
7,1,6,2017-11-13,partly-cloudy-night,nan
916,431,485,2018-01-07,clear-day,nan
6,2,4,2017-12-01,partly-cloudy-night,nan
115,62,53,2017-10-24,partly-cloudy-night,nan
1255,627,628,2017-11-14,partly-cloudy-day,nan
3,0,3,2018-01-09,partly-cloudy-night,nan
1476,753,723,2017-11-19,partly-cloudy-day,nan
25,11,14,2017-10-29,partly-cloudy-night,nan
376,200,176,2018-01-30,partly-cloudy-day,nan
971,444,527,2018-01-10,rain,nan
174,47,127,2018-01-09,clear-day,nan
193,94,99,2018-01-25,clear-day,nan
89,46,43,2017-12-09,partly-cloudy-night,nan
14,8,6,2017-12-27,clear-night,nan
11,9,2,2017-12-03,clear-night,nan
1900,1033,867,2018-01-01,clear-day,New Year's Day
586,263,323,2017-11-12,clear-night,nan
63,37,26,2017-12-18,partly-cloudy-night,nan
1463,703,760,2017-11-18,partly-cloudy-day,nan
8,3,5,2018-01-19,clear-night,nan
2,1,1,2017-12-31,clear-night,New Year's Eve
308,111,197,2017-12-07,clear-day,nan
113,77,36,2018-02-02,partly-cloudy-night,nan
19,10,9,2017-10-23,clear-night,nan
6,3,3,2018-01-18,clear-night,nan
734,340,394,2017-11-09,partly-cloudy-night,nan
73,39,34,2018-01-19,clear-night,nan
519,311,208,2017-11-19,partly-cloudy-day,nan
19,10,9,2017-11-02,partly-cloudy-night,nan
13,5,8,2017-11-03,partly-cloudy-night,nan
1437,782,655,2017-10-25,clear-day,nan
271,170,101,2018-01-06,clear-day,nan
1,0,1,2017-12-23,cloudy,nan
14,2,12,2018-01-09,clear-night,nan
286,172,114,2018-01-14,clear-day,nan
3816,1865,1951,2017-10-28,clear-day,nan
102,51,51,2017-10-30,clear-night,nan
16,9,7,2017-11-07,clear-night,nan
5,2,3,2017-12-12,partly-cloudy-night,nan
1415,677,738,2017-11-08,partly-cloudy-day,nan
0,0,0,2018-01-30,partly-cloudy-night,nan
422,247,175,2017-12-28,clear-day,nan
0,0,0,2018-01-02,clear-night,nan
142,68,74,2017-12-29,partly-cloudy-day,nan
26,20,6,2017-11-07,rain,nan
78,55,23,2017-11-23,clear-night,Thanksgiving Day
773,426,347,2017-12-19,partly-cloudy-day,nan
1145,697,448,2017-10-13,partly-cloudy-day,nan
143,43,100,2018-01-31,clear-day,nan
179,70,109,2017-11-17,clear-day,nan
662,420,242,2018-01-22,partly-cloudy-night,nan
1415,573,842,2017-12-08,clear-day,nan
5,4,1,2017-10-18,clear-night,nan
121,60,61,2017-12-23,cloudy,nan
19,12,7,2017-11-10,clear-night,Veterans Day observed
60,36,24,2017-11-01,clear-night,nan
131,30,101,2017-12-11,cloudy,nan
208,128,80,2017-12-02,clear-night,nan
10,8,2,2017-11-22,clear-night,nan
756,379,377,2017-10-26,partly-cloudy-night,nan
701,310,391,2017-12-13,partly-cloudy-day,nan
909,388,521,2018-01-09,clear-day,nan
1789,1005,784,2017-10-18,clear-day,nan
1794,842,952,2018-01-20,clear-day,nan
2164,1203,961,2017-12-30,partly-cloudy-day,nan
999,630,369,2017-10-22,clear-day,nan
518,298,220,2017-11-17,clear-night,nan
5,3,2,2017-12-13,partly-cloudy-night,nan
126,63,63,2018-01-04,snow,nan
153,83,70,2017-10-18,clear-night,nan
679,338,341,2018-01-08,partly-cloudy-day,nan
13,8,5,2018-01-30,partly-cloudy-night,nan
17,11,6,2017-12-10,partly-cloudy-night,nan
319,176,143,2017-12-10,partly-cloudy-night,nan
1805,880,925,2017-12-21,clear-day,nan
756,368,388,2018-01-15,partly-cloudy-day,Martin Luther King Jr. Day
97,74,23,2017-11-15,partly-cloudy-night,nan
120,56,64,2018-01-02,clear-night,nan
390,233,157,2018-01-03,clear-night,nan
1236,574,662,2017-12-24,clear-night,Christmas Eve
2428,1100,1328,2017-12-29,clear-day,nan
96,83,13,2018-02-04,rain,nan
497,304,193,2018-01-16,partly-cloudy-night,nan
17,8,9,2018-01-22,partly-cloudy-night,nan
401,255,146,2017-11-20,rain,nan
358,191,167,2017-11-04,partly-cloudy-day,nan
356,145,211,2017-10-07,clear-night,nan
326,191,135,2017-12-01,clear-night,nan
362,138,224,2017-10-02,clear-day,nan
1071,645,426,2017-10-02,clear-day,nan
16,4,12,2017-11-23,clear-night,Thanksgiving Day
9,6,3,2017-10-07,partly-cloudy-night,nan
3,1,2,2018-01-16,partly-cloudy-night,nan
326,234,92,2017-12-12,partly-cloudy-night,nan
735,354,381,2018-01-31,clear-day,nan
27,10,17,2017-10-12,partly-cloudy-night,nan
1693,701,992,2017-12-04,clear-day,nan
136,58,78,2017-12-20,clear-night,nan
301,142,159,2017-10-02,clear-night,nan
1022,559,463,2017-11-05,cloudy,Daylight Saving Time ends
3373,1796,1577,2017-10-07,clear-day,nan
12,6,6,2017-11-01,clear-night,nan
1530,786,744,2017-10-12,partly-cloudy-day,nan
1572,824,748,2017-10-03,clear-day,nan
134,77,57,2018-01-17,snow,nan
2371,1112,1259,2017-12-24,clear-day,Christmas Eve
5,3,2,2017-11-24,clear-night,Black Friday
1109,485,624,2017-12-06,clear-day,nan
34,25,9,2018-01-22,cloudy,nan
153,85,68,2017-10-24,partly-cloudy-night,nan
1504,762,742,2017-10-08,partly-cloudy-day,nan
76,39,37,2017-10-29,rain,nan
391,142,249,2017-10-13,partly-cloudy-day,nan
2247,1140,1107,2017-10-01,clear-day,nan
1747,857,890,2017-10-19,clear-day,nan
873,415,458,2018-01-29,partly-cloudy-day,nan
96,53,43,2017-11-27,clear-night,nan
1,0,1,2018-01-14,clear-night,nan
21,13,8,2017-10-07,partly-cloudy-night,nan
1,0,1,2018-01-08,partly-cloudy-night,nan
119,100,19,2017-12-07,clear-night,nan
2096,1046,1050,2017-10-16,clear-day,nan
2465,1197,1268,2017-10-31,clear-day,Halloween
3,1,2,2018-01-03,clear-night,nan
14,10,4,2017-10-26,partly-cloudy-night,nan
513,181,332,2017-10-25,clear-day,nan
20,15,5,2017-11-18,clear-night,nan
4,4,0,2017-11-04,clear-night,nan
1265,674,591,2017-10-24,partly-cloudy-day,nan
233,75,158,2017-11-07,partly-cloudy-day,nan
1190,553,637,2017-11-10,clear-day,Veterans Day observed
216,86,130,2017-10-08,partly-cloudy-day,nan
431,236,195,2017-12-16,clear-day,nan
775,379,396,2018-01-22,partly-cloudy-day,nan
1477,764,713,2017-10-18,clear-day,nan
401,268,133,2018-02-01,partly-cloudy-night,nan
162,133,29,2017-11-11,clear-night,Veterans Day
2,1,1,2017-10-29,rain,nan
213,93,120,2017-10-08,clear-night,nan
345,230,115,2017-12-19,clear-night,nan
1189,679,510,2017-10-17,clear-day,nan
149,68,81,2017-12-25,partly-cloudy-day,Christmas Day
2,1,1,2018-01-28,partly-cloudy-night,nan
315,180,135,2018-01-31,clear-day,nan
1428,661,767,2018-01-01,clear-night,New Year's Day
2464,1184,1280,2017-10-31,clear-day,Halloween
1518,657,861,2017-12-18,partly-cloudy-day,nan
133,53,80,2017-10-01,clear-night,nan
152,59,93,2017-12-07,clear-night,nan
127,40,87,2017-12-14,fog,nan
101,49,52,2017-11-27,clear-night,nan
376,171,205,2017-10-02,clear-night,nan
90,43,47,2018-01-25,clear-night,nan
8,4,4,2018-01-25,clear-night,nan
6,6,0,2017-11-05,partly-cloudy-night,Daylight Saving Time ends
202,145,57,2017-11-16,clear-night,nan
2,1,1,2018-01-14,clear-night,nan
824,414,410,2018-01-19,clear-night,nan
1505,634,871,2018-01-27,clear-day,nan
0,0,0,2017-12-31,clear-night,New Year's Eve
6,3,3,2017-11-02,partly-cloudy-night,nan
3,0,3,2018-02-02,partly-cloudy-night,nan
1396,539,857,2017-12-07,clear-day,nan
223,137,86,2018-01-12,partly-cloudy-night,nan
437,288,149,2018-01-08,partly-cloudy-night,nan
144,85,59,2017-10-12,clear-night,nan
20,10,10,2017-12-13,partly-cloudy-night,nan
195,88,107,2017-12-08,partly-cloudy-night,nan
335,161,174,2017-12-20,clear-day,nan
729,421,308,2018-01-20,clear-day,nan
56,34,22,2017-12-24,clear-night,Christmas Eve
398,255,143,2018-01-13,clear-night,nan
10,7,3,2018-01-16,partly-cloudy-night,nan
245,171,74,2017-11-27,clear-night,nan
50,33,17,2017-10-31,clear-night,Halloween
1428,771,657,2017-11-06,partly-cloudy-day,nan
1349,735,614,2017-11-04,clear-day,nan
16,9,7,2017-10-25,partly-cloudy-night,nan
2274,1222,1052,2017-10-30,partly-cloudy-day,nan
10,5,5,2017-10-25,clear-night,nan
13,7,6,2017-10-13,clear-night,nan
79,37,42,2017-12-03,clear-night,nan
40,30,10,2018-01-25,partly-cloudy-night,nan
729,369,360,2018-02-02,partly-cloudy-day,nan
217,146,71,2017-11-09,partly-cloudy-night,nan
848,390,458,2017-11-28,clear-day,nan
1517,799,718,2017-10-03,clear-day,nan
115,54,61,2017-10-05,partly-cloudy-night,nan
165,82,83,2017-12-14,clear-night,nan
122,76,46,2017-12-10,clear-night,nan
33,11,22,2018-01-08,partly-cloudy-night,nan
4,1,3,2018-01-22,partly-cloudy-night,nan
225,171,54,2017-12-21,clear-night,nan
297,143,154,2017-12-03,partly-cloudy-day,nan
283,146,137,2018-01-26,clear-day,nan
242,192,50,2017-11-16,clear-night,nan
1825,1089,736,2017-10-12,clear-day,nan
732,300,432,2017-10-09,partly-cloudy-day,Columbus Day (regional holiday)
101,56,45,2018-01-21,clear-night,nan
112,44,68,2017-11-22,rain,nan
10,5,5,2017-11-21,clear-night,nan
2191,1203,988,2017-10-23,partly-cloudy-day,nan
111,87,24,2017-12-02,clear-night,nan
232,165,67,2018-01-26,clear-night,nan
288,113,175,2017-10-11,partly-cloudy-night,nan
25,11,14,2017-12-28,clear-night,nan
8,5,3,2017-10-02,clear-night,nan
106,42,64,2018-02-01,partly-cloudy-night,nan
24,17,7,2017-10-18,clear-night,nan
2672,1468,1204,2017-10-27,clear-day,nan
994,414,580,2017-11-29,clear-day,nan
6,2,4,2017-12-30,clear-night,nan
70,34,36,2017-10-03,clear-night,nan
233,91,142,2017-10-17,clear-night,nan
1248,598,650,2017-11-17,clear-day,nan
2806,1234,1572,2017-12-02,clear-day,nan
2263,1233,1030,2017-10-01,clear-day,nan
401,288,113,2017-12-31,clear-day,New Year's Eve
435,257,178,2017-12-14,partly-cloudy-day,nan
84,67,17,2018-02-03,cloudy,nan
840,423,417,2017-12-09,fog,nan
2062,981,1081,2017-10-19,clear-day,nan
29,20,9,2017-11-09,clear-night,nan
84,40,44,2017-10-16,clear-night,nan
122,76,46,2017-10-03,clear-night,nan
1504,880,624,2018-01-01,clear-day,New Year's Day
708,424,284,2017-10-24,partly-cloudy-night,nan
2348,1130,1218,2017-12-24,clear-day,Christmas Eve
14,7,7,2018-01-05,clear-night,nan
5,2,3,2017-12-11,partly-cloudy-night,nan
36,17,19,2017-10-14,partly-cloudy-night,nan
116,59,57,2018-01-04,snow,nan
758,363,395,2018-01-29,clear-day,nan
68,46,22,2017-11-22,clear-night,nan
3,1,2,2018-01-05,clear-night,nan
6,3,3,2017-11-27,clear-night,nan
2877,1307,1570,2017-11-24,clear-day,Black Friday
1795,937,858,2017-10-26,partly-cloudy-day,nan
488,220,268,2017-11-02,clear-night,nan
88,52,36,2017-10-07,clear-night,nan
5,3,2,2018-01-23,cloudy,nan
2066,1112,954,2017-10-30,clear-day,nan
964,483,481,2017-12-17,clear-night,nan
1828,793,1035,2017-10-21,clear-day,nan
2,0,2,2017-12-08,clear-night,nan
107,45,62,2018-01-31,clear-night,nan
3,0,3,2018-02-03,clear-night,nan
23,14,9,2017-12-12,partly-cloudy-night,nan
1,0,1,2017-11-14,clear-night,nan
5,4,1,2017-11-16,partly-cloudy-night,nan
2241,1035,1206,2017-11-21,clear-day,nan
2,1,1,2017-12-23,partly-cloudy-night,nan
2733,1235,1498,2017-11-25,clear-day,nan
17,12,5,2017-10-03,clear-night,nan
217,117,100,2018-01-10,partly-cloudy-night,nan
39,24,15,2018-01-23,clear-night,nan
345,209,136,2018-01-23,partly-cloudy-night,nan
1412,892,520,2017-10-20,clear-day,nan
2691,1573,1118,2017-12-25,partly-cloudy-day,Christmas Day
1085,472,613,2017-11-15,clear-day,nan
218,92,126,2017-10-14,partly-cloudy-night,nan
539,271,268,2018-01-21,partly-cloudy-night,nan
11,8,3,2017-12-30,partly-cloudy-night,nan
647,288,359,2017-12-13,partly-cloudy-day,nan
693,383,310,2017-11-15,clear-day,nan
448,189,259,2017-10-10,clear-night,nan
239,109,130,2018-01-11,partly-cloudy-day,nan
22,12,10,2017-12-19,cloudy,nan
238,113,125,2017-11-08,partly-cloudy-day,nan
939,447,492,2018-01-15,partly-cloudy-day,Martin Luther King Jr. Day
2268,1100,1168,2017-11-03,clear-day,nan
1923,1027,896,2017-10-08,partly-cloudy-day,nan
4,2,2,2018-01-10,clear-night,nan
482,284,198,2017-11-22,partly-cloudy-day,nan
126,47,79,2017-10-30,rain,nan
27,21,6,2017-12-01,partly-cloudy-night,nan
7,5,2,2018-01-12,partly-cloudy-night,nan
1626,826,800,2017-11-09,partly-cloudy-day,nan
63,36,27,2017-12-08,clear-night,nan
105,92,13,2017-11-21,clear-night,nan
9,3,6,2018-01-16,cloudy,nan
2144,1171,973,2017-12-29,clear-day,nan
7,3,4,2018-01-07,clear-night,nan
684,341,343,2018-01-05,clear-day,nan
1657,808,849,2017-11-26,clear-day,nan
3049,1427,1622,2017-10-15,partly-cloudy-day,nan
71,37,34,2017-12-09,partly-cloudy-night,nan
2357,1128,1229,2017-10-23,partly-cloudy-day,nan
1608,794,814,2017-10-04,clear-day,nan
3633,1834,1799,2017-10-07,clear-day,nan
92,57,35,2017-10-29,partly-cloudy-night,nan
1455,739,716,2018-01-13,clear-day,nan
234,123,111,2017-11-01,partly-cloudy-night,nan
109,62,47,2017-11-10,clear-night,Veterans Day observed
0,0,0,2017-10-26,partly-cloudy-night,nan
541,242,299,2017-11-19,partly-cloudy-night,nan
139,60,79,2018-01-06,clear-night,nan
2575,1209,1366,2017-12-26,clear-day,nan
92,54,38,2018-01-07,clear-day,nan
26,10,16,2018-01-05,clear-night,nan
4,2,2,2018-01-14,clear-night,nan
783,233,550,2017-10-08,clear-night,nan
517,286,231,2017-11-20,partly-cloudy-day,nan
278,136,142,2018-01-22,partly-cloudy-day,nan
73,31,42,2017-12-28,clear-night,nan
1499,680,819,2017-11-07,partly-cloudy-day,nan
88,52,36,2017-10-17,clear-night,nan
2307,1044,1263,2018-01-20,clear-day,nan
26,19,7,2017-10-08,partly-cloudy-night,nan
3297,1496,1801,2017-11-04,clear-day,nan
1956,1129,827,2017-10-05,clear-day,nan
283,148,135,2017-10-29,partly-cloudy-day,nan
284,182,102,2018-01-14,clear-night,nan
7,4,3,2017-12-17,partly-cloudy-night,nan
1223,561,662,2017-11-28,partly-cloudy-day,nan
589,329,260,2017-11-23,clear-day,Thanksgiving Day
30,15,15,2018-01-12,partly-cloudy-night,nan
16,6,10,2017-10-10,clear-night,nan
2424,1331,1093,2017-12-29,clear-day,nan
2,1,1,2018-01-19,clear-night,nan
118,47,71,2018-01-01,clear-night,New Year's Day
199,73,126,2017-12-26,clear-night,nan
687,436,251,2017-10-12,partly-cloudy-day,nan
14,13,1,2018-01-01,clear-night,New Year's Day
52,17,35,2018-01-08,clear-night,nan
142,44,98,2018-01-18,clear-day,nan
1175,555,620,2018-01-09,clear-day,nan
120,64,56,2017-12-18,partly-cloudy-night,nan
77,52,25,2018-01-12,cloudy,nan
493,272,221,2018-02-02,clear-day,nan
2329,1199,1130,2017-11-02,clear-day,nan
795,410,385,2018-02-04,partly-cloudy-day,nan
116,78,38,2018-01-18,clear-night,nan
29,17,12,2018-01-09,clear-night,nan
1035,449,586,2017-11-16,partly-cloudy-day,nan
1046,418,628,2017-12-05,partly-cloudy-day,nan
35,16,19,2017-12-15,clear-night,nan
8,4,4,2017-11-12,clear-night,nan
1522,916,606,2017-10-18,clear-day,nan
848,425,423,2018-01-24,partly-cloudy-day,nan
571,299,272,2017-10-04,clear-day,nan
1853,819,1034,2017-12-03,partly-cloudy-day,nan
1,0,1,2018-01-30,partly-cloudy-night,nan
976,472,504,2017-11-13,partly-cloudy-day,nan
2079,954,1125,2017-10-31,clear-day,Halloween
13,8,5,2017-11-26,clear-night,nan
517,297,220,2017-12-27,partly-cloudy-day,nan
1712,998,714,2017-10-16,clear-day,nan
10,5,5,2018-01-03,clear-night,nan
17,10,7,2017-12-06,partly-cloudy-night,nan
27,14,13,2017-11-11,clear-night,Veterans Day
1716,771,945,2017-11-11,clear-day,Veterans Day
2,0,2,2018-01-04,partly-cloudy-night,nan
1313,571,742,2017-12-20,clear-day,nan
5,3,2,2018-02-01,clear-night,nan
2250,1076,1174,2018-01-02,clear-day,nan
8,4,4,2017-12-02,clear-night,nan
381,261,120,2017-12-06,clear-night,nan
34,20,14,2018-01-04,partly-cloudy-night,nan
2323,1146,1177,2017-10-10,clear-day,nan
80,46,34,2017-12-04,partly-cloudy-night,nan
10,6,4,2017-10-16,partly-cloudy-night,nan
582,245,337,2017-10-19,clear-night,nan
11,6,5,2017-10-04,clear-night,nan
1659,762,897,2017-10-24,partly-cloudy-day,nan
199,72,127,2017-10-01,clear-day,nan
576,366,210,2017-12-11,clear-night,nan
5,5,0,2018-01-20,clear-night,nan
1803,843,960,2017-11-17,clear-day,nan
37,24,13,2017-10-11,clear-night,nan
2,1,1,2017-12-28,clear-night,nan
113,49,64,2018-01-27,clear-night,nan
183,128,55,2017-12-13,clear-night,nan
711,338,373,2018-01-31,clear-day,nan
1731,868,863,2017-10-31,clear-day,Halloween
37,25,12,2017-10-14,partly-cloudy-night,nan
571,294,277,2018-01-31,partly-cloudy-day,nan
13,8,5,2017-10-22,clear-night,nan
1410,730,680,2017-11-06,partly-cloudy-day,nan
1637,867,770,2017-10-02,clear-day,nan
23,14,9,2017-10-28,clear-night,nan
489,262,227,2017-11-13,partly-cloudy-day,nan
81,79,2,2017-12-15,clear-night,nan
5,2,3,2017-10-19,clear-night,nan
151,135,16,2018-01-28,clear-night,nan
338,216,122,2018-01-25,clear-night,nan
3,3,0,2017-10-05,partly-cloudy-night,nan
1483,764,719,2017-10-26,partly-cloudy-day,nan
2276,1159,1117,2017-10-13,partly-cloudy-day,nan
576,346,230,2017-11-16,clear-night,nan
6,3,3,2018-01-08,partly-cloudy-night,nan
152,85,67,2017-10-12,partly-cloudy-night,nan
1060,581,479,2017-12-10,clear-day,nan
757,341,416,2018-01-29,partly-cloudy-day,nan
881,480,401,2017-10-09,partly-cloudy-day,Columbus Day (regional holiday)
849,386,463,2017-12-05,partly-cloudy-day,nan
103,46,57,2017-10-25,partly-cloudy-night,nan
1046,505,541,2018-01-28,partly-cloudy-day,nan
273,111,162,2017-11-27,clear-day,nan
103,85,18,2017-11-29,clear-night,nan
1924,911,1013,2017-12-31,clear-day,New Year's Eve
14,8,6,2017-12-22,clear-night,nan
1754,775,979,2017-11-24,clear-day,Black Friday
41,21,20,2017-11-05,cloudy,Daylight Saving Time ends
1,0,1,2017-12-26,clear-night,nan
116,90,26,2017-11-18,partly-cloudy-night,nan
1,0,1,2017-11-07,clear-night,nan
970,527,443,2017-12-09,fog,nan
173,90,83,2017-12-30,clear-night,nan
279,145,134,2017-10-20,clear-night,nan
1015,470,545,2018-01-26,clear-day,nan
488,206,282,2017-11-03,partly-cloudy-night,nan
43,20,23,2017-12-30,partly-cloudy-night,nan
3,2,1,2017-10-17,clear-night,nan
15,10,5,2017-12-18,partly-cloudy-night,nan
212,86,126,2017-12-01,clear-night,nan
3587,1899,1688,2017-10-21,clear-day,nan
526,327,199,2017-12-24,clear-day,Christmas Eve
2,1,1,2018-01-26,clear-night,nan
27,13,14,2017-11-15,partly-cloudy-night,nan
799,353,446,2018-01-18,clear-day,nan
260,122,138,2017-10-27,clear-night,nan
15,9,6,2018-01-23,rain,nan
1566,767,799,2017-11-01,partly-cloudy-day,nan
622,268,354,2017-11-25,partly-cloudy-night,nan
289,131,158,2018-01-17,partly-cloudy-day,nan
191,146,45,2018-01-17,partly-cloudy-night,nan
4,3,1,2018-02-04,cloudy,nan
758,512,246,2017-10-15,partly-cloudy-day,nan
297,158,139,2017-11-05,cloudy,Daylight Saving Time ends
221,99,122,2017-10-16,partly-cloudy-night,nan
179,85,94,2017-12-04,partly-cloudy-night,nan
47,24,23,2017-10-24,partly-cloudy-night,nan
312,174,138,2018-01-05,clear-day,nan
1123,540,583,2017-12-28,clear-night,nan
340,153,187,2017-10-23,partly-cloudy-night,nan
649,314,335,2018-01-06,clear-day,nan
192,96,96,2018-01-18,clear-day,nan
46,25,21,2017-11-04,clear-night,nan
307,133,174,2017-10-05,partly-cloudy-night,nan
661,338,323,2017-10-26,partly-cloudy-day,nan
41,16,25,2017-12-27,clear-night,nan
2331,1550,781,2017-10-14,partly-cloudy-day,nan
178,131,47,2017-12-07,partly-cloudy-night,nan
30,17,13,2017-12-23,partly-cloudy-night,nan
194,157,37,2018-01-24,clear-night,nan
1354,695,659,2018-01-03,clear-day,nan
2,1,1,2018-01-03,clear-night,nan
42,27,15,2017-12-15,partly-cloudy-night,nan
10,6,4,2017-12-12,partly-cloudy-night,nan
1136,557,579,2017-10-25,partly-cloudy-night,nan
471,184,287,2017-10-06,clear-night,nan
285,146,139,2017-11-03,clear-night,nan
1649,709,940,2017-12-19,partly-cloudy-day,nan
184,91,93,2017-10-09,partly-cloudy-night,Columbus Day (regional holiday)
1021,546,475,2017-11-18,clear-day,nan
76,42,34,2017-10-31,clear-night,Halloween
83,51,32,2018-01-10,cloudy,nan
159,88,71,2017-10-26,clear-night,nan
75,47,28,2018-01-23,clear-night,nan
737,278,459,2017-10-04,clear-night,nan
1828,910,918,2017-12-17,clear-day,nan
16,8,8,2017-10-21,clear-night,nan
302,162,140,2017-11-05,partly-cloudy-day,Daylight Saving Time ends
0,0,0,2017-10-30,partly-cloudy-night,nan
3066,1457,1609,2017-10-22,clear-day,nan
1478,893,585,2017-10-03,clear-day,nan
602,347,255,2018-02-04,partly-cloudy-day,nan
40,17,23,2017-10-11,clear-night,nan
1602,843,759,2017-10-11,clear-day,nan
391,209,182,2018-01-09,clear-day,nan
135,102,33,2018-01-30,partly-cloudy-night,nan
1857,881,976,2017-12-16,partly-cloudy-day,nan
9,4,5,2017-11-25,clear-night,nan
4,3,1,2018-01-25,clear-night,nan
9,5,4,2018-01-17,partly-cloudy-night,nan
119,52,67,2017-11-12,clear-night,nan
250,106,144,2017-11-07,clear-day,nan
15,12,3,2018-02-03,clear-night,nan
160,93,67,2017-11-17,clear-night,nan
2,1,1,2017-11-10,clear-night,Veterans Day observed
483,275,208,2018-01-28,partly-cloudy-night,nan
5,5,0,2017-10-27,clear-night,nan
3,2,1,2017-11-08,partly-cloudy-night,nan
58,27,31,2017-11-26,partly-cloudy-night,nan
278,160,118,2017-12-04,partly-cloudy-night,nan
10,4,6,2017-11-02,partly-cloudy-night,nan
28,9,19,2018-01-14,clear-night,nan
283,183,100,2017-11-30,partly-cloudy-night,nan
48,20,28,2018-01-04,snow,nan
101,39,62,2018-01-19,clear-night,nan
227,124,103,2017-11-09,partly-cloudy-day,nan
2022,802,1220,2017-11-12,clear-day,nan
148,66,82,2018-01-02,clear-night,nan
44,39,5,2018-01-20,clear-night,nan
105,52,53,2017-11-23,clear-night,Thanksgiving Day
116,63,53,2018-01-03,partly-cloudy-night,nan
192,104,88,2018-01-15,clear-day,Martin Luther King Jr. Day
518,236,282,2017-10-28,partly-cloudy-night,nan
2602,1510,1092,2017-10-07,clear-day,nan
9,8,1,2018-01-31,clear-night,nan
58,45,13,2017-10-09,partly-cloudy-night,Columbus Day (regional holiday)
31,13,18,2017-11-19,clear-night,nan
1374,561,813,2017-11-27,clear-day,nan
1030,455,575,2018-01-11,cloudy,nan
72,46,26,2018-02-01,cloudy,nan
1705,817,888,2017-10-05,rain,nan
1860,880,980,2017-10-14,partly-cloudy-day,nan
0,0,0,2018-01-06,clear-night,nan
810,461,349,2018-01-27,clear-day,nan
135,79,56,2017-10-20,clear-night,nan
182,121,61,2017-11-08,partly-cloudy-night,nan
21,13,8,2017-11-14,clear-night,nan
189,81,108,2017-12-21,clear-day,nan
74,38,36,2018-01-21,cloudy,nan
65,30,35,2018-01-30,partly-cloudy-night,nan
73,48,25,2017-12-15,partly-cloudy-night,nan
180,68,112,2017-11-16,rain,nan
275,139,136,2018-01-16,partly-cloudy-day,nan
133,64,69,2017-12-10,clear-day,nan
1,0,1,2017-11-08,partly-cloudy-night,nan
292,126,166,2017-10-29,rain,nan
2763,1378,1385,2017-10-22,clear-day,nan
170,121,49,2017-11-18,rain,nan
436,256,180,2018-01-24,partly-cloudy-day,nan
57,44,13,2017-11-10,clear-night,Veterans Day observed
1689,807,882,2017-12-26,clear-day,nan
229,139,90,2018-01-09,clear-night,nan
84,26,58,2017-11-19,partly-cloudy-night,nan
1244,686,558,2017-10-06,clear-day,nan
607,322,285,2017-12-16,cloudy,nan
6,4,2,2017-11-28,clear-night,nan
1005,470,535,2018-01-10,clear-day,nan
45,24,21,2017-12-20,clear-night,nan
1309,721,588,2017-10-17,clear-day,nan
343,184,159,2018-02-01,partly-cloudy-day,nan
695,328,367,2018-01-07,clear-day,nan
1053,565,488,2017-12-01,clear-day,nan
13,1,12,2018-01-06,clear-night,nan
718,324,394,2018-01-22,clear-day,nan
3,1,2,2018-01-09,cloudy,nan
767,364,403,2017-12-06,clear-day,nan
270,156,114,2017-12-10,clear-night,nan
5,0,5,2018-01-01,clear-night,New Year's Day
161,140,21,2017-11-09,partly-cloudy-night,nan
1185,634,551,2017-12-30,partly-cloudy-day,nan
1512,626,886,2017-11-20,partly-cloudy-day,nan
33,11,22,2017-11-02,partly-cloudy-night,nan
2295,1235,1060,2017-11-04,clear-day,nan
1,0,1,2018-01-27,clear-night,nan
1768,951,817,2017-12-25,partly-cloudy-day,Christmas Day
19,12,7,2018-01-24,cloudy,nan
2603,1268,1335,2017-10-27,clear-day,nan
696,367,329,2017-11-13,partly-cloudy-day,nan
10,8,2,2018-01-15,partly-cloudy-night,Martin Luther King Jr. Day
4,3,1,2017-10-29,rain,nan
258,182,76,2017-11-21,clear-night,nan
130,43,87,2018-01-12,cloudy,nan
667,385,282,2017-11-14,partly-cloudy-day,nan
1776,900,876,2017-10-12,partly-cloudy-day,nan
32,16,16,2017-11-30,clear-night,nan
1587,634,953,2017-12-03,partly-cloudy-day,nan
3,2,1,2018-01-18,clear-night,nan
5,4,1,2017-11-06,partly-cloudy-night,nan
103,52,51,2017-12-26,clear-night,nan
1972,955,1017,2017-11-02,clear-day,nan
1363,592,771,2017-12-08,partly-cloudy-day,nan
0,0,0,2017-12-29,clear-night,nan
103,58,45,2017-10-19,clear-night,nan
312,181,131,2017-11-06,clear-night,nan
11,4,7,2017-12-26,clear-night,nan
508,213,295,2018-01-07,clear-night,nan
103,47,56,2017-11-12,clear-day,nan
94,88,6,2017-11-19,clear-night,nan
296,141,155,2017-10-10,clear-night,nan
508,208,300,2017-10-26,partly-cloudy-day,nan
4,2,2,2018-01-31,clear-night,nan
1119,720,399,2017-10-17,clear-day,nan
8,3,5,2017-11-11,clear-night,Veterans Day
1574,860,714,2017-10-13,partly-cloudy-day,nan
51,15,36,2018-01-04,snow,nan
2140,1136,1004,2017-10-06,clear-day,nan
247,118,129,2017-11-16,partly-cloudy-day,nan
681,282,399,2018-01-25,clear-day,nan
1546,700,846,2018-02-03,clear-day,nan
1978,994,984,2017-10-24,partly-cloudy-day,nan
85,80,5,2017-12-13,partly-cloudy-night,nan
16,7,9,2018-01-17,partly-cloudy-night,nan
1750,836,914,2018-01-02,clear-day,nan
2233,1036,1197,2017-11-11,clear-day,Veterans Day
530,235,295,2018-01-23,partly-cloudy-day,nan
386,284,102,2017-11-29,clear-night,nan
619,295,324,2018-01-18,clear-night,nan
23,13,10,2017-12-24,clear-night,Christmas Eve
1931,1102,829,2017-10-13,partly-cloudy-day,nan
1632,678,954,2017-12-01,clear-day,nan
1162,557,605,2018-01-14,clear-day,nan
2320,1079,1241,2017-12-27,clear-day,nan
1499,896,603,2017-10-10,clear-day,nan
20,11,9,2017-10-01,partly-cloudy-night,nan
127,39,88,2017-12-11,partly-cloudy-night,nan
225,117,108,2017-11-26,clear-night,nan
849,329,520,2018-02-01,clear-day,nan
793,421,372,2018-01-08,partly-cloudy-day,nan
16,12,4,2017-11-22,clear-night,nan
243,130,113,2017-12-02,clear-day,nan
8,5,3,2018-01-04,wind,nan
0,0,0,2017-10-12,partly-cloudy-night,nan
1203,670,533,2017-11-05,partly-cloudy-day,Daylight Saving Time ends
142,101,41,2017-11-15,partly-cloudy-night,nan
74,29,45,2017-10-22,clear-night,nan
32,21,11,2018-02-02,clear-night,nan
200,95,105,2017-12-29,clear-night,nan
111,63,48,2017-10-19,clear-night,nan
1402,1375,27,2017-12-31,clear-night,New Year's Eve
83,44,39,2017-10-18,clear-night,nan
24,11,13,2017-10-11,clear-night,nan
412,159,253,2017-10-04,clear-day,nan
12,7,5,2017-10-28,clear-night,nan
2239,1012,1227,2017-12-10,rain,nan
1046,649,397,2017-11-08,partly-cloudy-day,nan
268,119,149,2017-10-07,partly-cloudy-night,nan
5,2,3,2018-01-21,clear-night,nan
123,43,80,2018-02-02,partly-cloudy-day,nan
13,5,8,2017-12-22,partly-cloudy-night,nan
1617,860,757,2017-10-02,clear-day,nan
6,1,5,2017-12-15,clear-night,nan
9,4,5,2017-12-26,clear-night,nan
514,261,253,2018-01-28,partly-cloudy-day,nan
2962,2267,695,2017-10-28,clear-day,nan
687,406,281,2018-01-13,partly-cloudy-day,nan
6,0,6,2017-12-05,partly-cloudy-night,nan
417,200,217,2017-12-23,rain,nan
147,96,51,2017-11-28,clear-night,nan
2290,1374,916,2017-10-20,clear-day,nan
316,233,83,2017-11-14,partly-cloudy-night,nan
624,391,233,2017-12-07,clear-night,nan
270,179,91,2018-02-03,clear-day,nan
2715,1610,1105,2017-12-25,partly-cloudy-day,Christmas Day
6,5,1,2017-10-31,clear-night,Halloween
2,1,1,2017-12-21,clear-night,nan
1,1,0,2017-11-13,clear-night,nan
86,42,44,2018-01-02,clear-night,nan
1639,1008,631,2017-10-21,clear-day,nan
2,1,1,2017-10-29,partly-cloudy-night,nan
264,151,113,2018-01-30,partly-cloudy-day,nan
56,27,29,2018-02-04,partly-cloudy-night,nan
159,52,107,2018-01-26,clear-day,nan
28,25,3,2017-12-05,rain,nan
232,105,127,2017-12-15,clear-day,nan
12,2,10,2018-02-01,partly-cloudy-night,nan
24,9,15,2017-12-09,partly-cloudy-night,nan
37,26,11,2018-01-17,partly-cloudy-night,nan
224,98,126,2017-12-27,partly-cloudy-day,nan
184,94,90,2017-11-24,clear-day,Black Friday
7,3,4,2017-12-18,cloudy,nan
1141,586,555,2017-10-18,clear-day,nan
85,43,42,2017-12-13,clear-night,nan
1740,726,1014,2017-11-18,partly-cloudy-day,nan
305,143,162,2017-12-27,clear-night,nan
1,0,1,2017-11-20,partly-cloudy-night,nan
272,105,167,2017-11-20,partly-cloudy-day,nan
1971,994,977,2017-10-25,partly-cloudy-day,nan
2742,1325,1417,2017-10-07,clear-day,nan
7,5,2,2017-10-23,partly-cloudy-night,nan
351,120,231,2017-11-09,partly-cloudy-day,nan
20,16,4,2018-01-20,clear-night,nan
3,2,1,2017-12-01,partly-cloudy-night,nan
312,246,66,2018-02-02,partly-cloudy-night,nan
1,1,0,2017-11-03,clear-night,nan
679,350,329,2018-01-05,clear-day,nan
14,6,8,2018-01-25,clear-night,nan
2333,1136,1197,2018-01-03,clear-day,nan
162,67,95,2017-10-29,partly-cloudy-day,nan
3852,1927,1925,2017-10-28,clear-day,nan
755,343,412,2018-01-19,clear-day,nan
56,37,19,2018-01-11,partly-cloudy-night,nan
321,181,140,2017-10-23,partly-cloudy-night,nan
483,231,252,2017-12-19,partly-cloudy-day,nan
1,0,1,2017-11-29,clear-night,nan
1363,690,673,2017-11-08,partly-cloudy-day,nan
131,66,65,2017-12-24,cloudy,Christmas Eve
1836,947,889,2017-10-16,clear-day,nan
1657,855,802,2017-10-11,partly-cloudy-day,nan
91,52,39,2018-01-28,partly-cloudy-night,nan
42,14,28,2018-01-13,partly-cloudy-night,nan
3,0,3,2017-12-10,clear-night,nan
12,7,5,2017-11-23,clear-night,Thanksgiving Day
1763,918,845,2017-12-28,clear-day,nan
9,3,6,2018-01-02,clear-night,nan
107,60,47,2017-11-17,partly-cloudy-night,nan
78,36,42,2017-10-28,clear-night,nan
878,490,388,2017-10-09,partly-cloudy-day,Columbus Day (regional holiday)
287,147,140,2017-10-21,clear-night,nan
7,4,3,2018-01-11,partly-cloudy-night,nan
1835,910,925,2017-10-05,clear-day,nan
308,153,155,2017-11-03,partly-cloudy-night,nan
272,113,159,2017-12-02,clear-night,nan
7,2,5,2017-11-15,partly-cloudy-night,nan
15,10,5,2017-11-01,clear-night,nan
8,4,4,2018-01-30,clear-night,nan
757,332,425,2018-01-18,clear-day,nan
164,92,72,2017-12-22,partly-cloudy-night,nan
0,0,0,2018-02-05,partly-cloudy-night,nan
1447,777,670,2017-10-26,partly-cloudy-day,nan
2907,1560,1347,2017-10-22,clear-day,nan
202,87,115,2018-01-20,clear-night,nan
334,169,165,2017-12-31,clear-night,New Year's Eve
2,1,1,2017-11-09,clear-night,nan
527,268,259,2017-11-25,clear-night,nan
43,26,17,2017-10-15,partly-cloudy-night,nan
15,8,7,2017-10-06,clear-night,nan
316,126,190,2017-12-01,clear-day,nan
4,1,3,2018-01-06,clear-night,nan
1011,477,534,2017-11-17,clear-night,nan
2314,1111,1203,2018-01-27,clear-day,nan
1160,649,511,2017-11-12,clear-day,nan
15,7,8,2018-01-03,clear-night,nan
90,43,47,2018-01-15,clear-night,Martin Luther King Jr. Day
6,4,2,2018-01-17,cloudy,nan
1567,669,898,2017-12-21,clear-day,nan
636,249,387,2017-10-15,cloudy,nan
1069,657,412,2017-11-01,cloudy,nan
16,6,10,2017-10-24,partly-cloudy-night,nan
275,181,94,2018-01-29,cloudy,nan
224,93,131,2017-11-10,clear-day,Veterans Day observed
10,8,2,2017-10-20,clear-night,nan
3,2,1,2017-11-19,rain,nan
310,149,161,2017-11-04,clear-night,nan
359,172,187,2017-11-04,partly-cloudy-night,nan
1922,929,993,2017-12-04,clear-day,nan
662,344,318,2018-01-16,partly-cloudy-day,nan
22,17,5,2017-10-09,partly-cloudy-night,Columbus Day (regional holiday)
64,32,32,2017-10-07,clear-night,nan
753,371,382,2017-11-13,partly-cloudy-night,nan
752,351,401,2018-01-31,clear-day,nan
870,348,522,2018-01-13,clear-night,nan
14,10,4,2018-01-15,clear-night,Martin Luther King Jr. Day
203,141,62,2017-12-16,partly-cloudy-night,nan
1586,668,918,2017-12-04,clear-day,nan
477,191,286,2017-11-02,partly-cloudy-day,nan
277,223,54,2017-12-12,partly-cloudy-night,nan
82,72,10,2017-12-14,clear-night,nan
88,39,49,2018-01-04,partly-cloudy-night,nan
45,26,19,2017-10-03,clear-night,nan
278,106,172,2017-10-22,clear-night,nan
2068,1064,1004,2017-10-30,partly-cloudy-day,nan
32,24,8,2017-10-24,partly-cloudy-night,nan
413,245,168,2017-11-11,clear-night,Veterans Day
387,285,102,2017-12-13,clear-night,nan
4,2,2,2017-10-25,clear-night,nan
861,417,444,2017-11-05,cloudy,Daylight Saving Time ends
1,0,1,2018-01-22,partly-cloudy-night,nan
37,24,13,2017-10-29,rain,nan
10,6,4,2017-12-03,partly-cloudy-night,nan
1686,901,785,2017-10-03,clear-day,nan
38,17,21,2018-01-28,rain,nan
1355,612,743,2017-12-06,clear-day,nan
2571,1285,1286,2017-10-27,clear-day,nan
1052,505,547,2017-12-21,clear-night,nan
39,18,21,2018-01-08,partly-cloudy-night,nan
1145,452,693,2017-11-12,clear-night,nan
251,117,134,2017-10-13,partly-cloudy-night,nan
2142,1091,1051,2017-10-01,clear-day,nan
1127,523,604,2017-11-14,partly-cloudy-day,nan
341,137,204,2017-11-06,cloudy,nan
94,55,39,2018-01-19,clear-night,nan
324,187,137,2017-10-30,partly-cloudy-day,nan
1437,739,698,2017-10-12,clear-day,nan
1,0,1,2018-02-02,partly-cloudy-night,nan
1,0,1,2017-12-07,clear-night,nan
9,5,4,2018-01-07,partly-cloudy-night,nan
11,3,8,2017-11-18,clear-night,nan
11,6,5,2017-11-21,clear-night,nan
84,55,29,2017-10-07,partly-cloudy-night,nan
180,89,91,2017-12-25,clear-night,Christmas Day
915,431,484,2017-12-12,partly-cloudy-day,nan
311,99,212,2017-11-28,clear-day,nan
1730,921,809,2017-10-30,partly-cloudy-day,nan
103,67,36,2017-12-31,clear-day,New Year's Eve
42,18,24,2017-11-06,clear-night,nan
91,51,40,2017-10-18,clear-night,nan
1103,544,559,2017-11-10,clear-day,Veterans Day observed
104,57,47,2017-10-04,partly-cloudy-night,nan
101,41,60,2017-12-05,partly-cloudy-night,nan
111,56,55,2017-12-29,partly-cloudy-night,nan
89,42,47,2017-12-23,rain,nan
219,173,46,2017-12-06,clear-night,nan
99,56,43,2018-01-16,partly-cloudy-night,nan
3187,1584,1603,2017-10-14,cloudy,nan
1813,869,944,2017-12-08,clear-day,nan
82,57,25,2018-01-22,partly-cloudy-night,nan
211,146,65,2017-12-20,clear-night,nan
455,248,207,2017-11-09,partly-cloudy-night,nan
5,4,1,2017-11-22,clear-night,nan
275,141,134,2017-10-31,clear-night,Halloween
1916,923,993,2018-01-20,clear-day,nan
69,40,29,2018-01-13,clear-night,nan
31,7,24,2017-11-27,clear-night,nan
2021,1126,895,2017-12-30,partly-cloudy-day,nan
1,0,1,2017-12-14,partly-cloudy-night,nan
963,445,518,2018-01-26,clear-day,nan
13,8,5,2017-12-13,partly-cloudy-night,nan
77,34,43,2018-01-09,clear-night,nan
210,103,107,2017-11-22,partly-cloudy-night,nan
276,163,113,2018-01-08,clear-day,nan
233,73,160,2018-01-22,partly-cloudy-day,nan
464,250,214,2017-12-03,partly-cloudy-night,nan
14,11,3,2017-10-18,clear-night,nan
79,39,40,2017-11-21,clear-night,nan
702,315,387,2018-01-27,clear-night,nan
189,94,95,2017-12-01,clear-night,nan
16,6,10,2017-12-30,clear-night,nan
65,34,31,2017-10-11,partly-cloudy-night,nan
575,363,212,2017-11-15,cloudy,nan
181,92,89,2017-10-13,partly-cloudy-night,nan
234,79,155,2018-01-29,clear-day,nan
14,10,4,2018-01-29,clear-night,nan
42,18,24,2018-01-26,clear-night,nan
551,322,229,2017-11-11,clear-day,Veterans Day
22,11,11,2018-01-21,clear-night,nan
1050,599,451,2018-01-19,clear-day,nan
103,37,66,2017-12-11,partly-cloudy-night,nan
368,233,135,2018-02-03,clear-night,nan
166,81,85,2018-01-23,rain,nan
7,2,5,2017-10-03,clear-night,nan
115,59,56,2017-11-13,clear-night,nan
2331,1154,1177,2017-12-02,clear-day,nan
7,4,3,2018-01-16,partly-cloudy-night,nan
613,240,373,2017-10-03,clear-night,nan
169,81,88,2017-10-09,partly-cloudy-night,Columbus Day (regional holiday)
56,28,28,2017-10-29,partly-cloudy-night,nan
1,0,1,2017-12-27,partly-cloudy-night,nan
1090,495,595,2017-12-14,partly-cloudy-day,nan
345,183,162,2017-12-22,partly-cloudy-night,nan
1414,599,815,2017-12-11,clear-day,nan
2629,1527,1102,2018-01-01,clear-day,New Year's Day
57,28,29,2018-01-11,partly-cloudy-night,nan
1261,536,725,2017-11-29,clear-day,nan
2,1,1,2017-12-30,partly-cloudy-night,nan
1115,491,624,2017-12-15,partly-cloudy-day,nan
3,1,2,2017-11-24,clear-night,Black Friday
1181,520,661,2017-11-30,partly-cloudy-day,nan
13,7,6,2017-12-08,clear-night,nan
101,85,16,2018-01-21,clear-night,nan
164,91,73,2017-10-08,partly-cloudy-day,nan
553,275,278,2018-01-30,partly-cloudy-day,nan
106,60,46,2017-11-02,partly-cloudy-night,nan
2599,1280,1319,2017-10-08,partly-cloudy-day,nan
818,309,509,2017-10-14,partly-cloudy-night,nan
1732,857,875,2017-11-19,partly-cloudy-day,nan
1344,670,674,2018-01-21,clear-day,nan
1072,599,473,2017-11-19,partly-cloudy-day,nan
584,303,281,2017-10-19,clear-day,nan
2764,1040,1724,2017-10-01,clear-day,nan
53,21,32,2017-11-13,partly-cloudy-night,nan
797,367,430,2017-10-25,clear-day,nan
1002,573,429,2017-10-16,clear-day,nan
166,75,91,2017-10-30,clear-night,nan
244,111,133,2017-10-21,clear-night,nan
263,149,114,2017-12-17,partly-cloudy-night,nan
91,49,42,2017-11-05,partly-cloudy-night,Daylight Saving Time ends
184,80,104,2017-12-14,partly-cloudy-day,nan
6,3,3,2018-02-04,cloudy,nan
9,4,5,2018-01-10,clear-night,nan
1519,720,799,2017-11-22,clear-day,nan
1735,862,873,2017-11-21,clear-day,nan
277,140,137,2017-10-20,clear-night,nan
141,97,44,2018-01-06,clear-day,nan
292,193,99,2018-01-03,clear-night,nan
279,120,159,2017-10-06,partly-cloudy-night,nan
1046,618,428,2018-01-01,clear-day,New Year's Day
1608,751,857,2017-12-22,partly-cloudy-day,nan
2106,994,1112,2017-12-28,clear-day,nan
292,120,172,2017-11-24,clear-night,Black Friday
12,8,4,2017-12-16,clear-night,nan
666,323,343,2017-12-13,partly-cloudy-day,nan
42,18,24,2017-10-15,partly-cloudy-night,nan
30,19,11,2017-12-19,cloudy,nan
30,16,14,2017-11-15,partly-cloudy-night,nan
2102,1066,1036,2017-10-20,clear-day,nan
23,11,12,2017-10-25,partly-cloudy-night,nan
7,4,3,2017-12-09,partly-cloudy-night,nan
168,75,93,2018-01-05,clear-night,nan
5,3,2,2017-12-04,clear-night,nan
1466,659,807,2018-01-21,clear-day,nan
280,116,164,2018-01-12,rain,nan
1914,929,985,2017-11-09,partly-cloudy-day,nan
1,0,1,2018-01-15,clear-night,Martin Luther King Jr. Day
53,20,33,2018-01-17,cloudy,nan
28,11,17,2018-01-29,partly-cloudy-night,nan
2454,1263,1191,2017-11-03,clear-day,nan
13,8,5,2017-12-09,partly-cloudy-night,nan
1,0,1,2017-12-25,cloudy,Christmas Day
107,53,54,2017-10-15,partly-cloudy-night,nan
5,1,4,2017-11-17,clear-night,nan
136,55,81,2017-12-05,partly-cloudy-night,nan
1746,793,953,2017-11-23,clear-day,Thanksgiving Day
588,308,280,2017-12-12,partly-cloudy-day,nan
612,410,202,2017-11-20,rain,nan
194,91,103,2018-02-04,partly-cloudy-day,nan
3191,1527,1664,2017-11-25,clear-day,nan
570,198,372,2017-10-27,clear-night,nan
148,92,56,2018-01-11,clear-night,nan
274,190,84,2017-11-20,clear-night,nan
0,0,0,2018-01-07,clear-night,nan
2530,1314,1216,2017-10-23,clear-day,nan
14,12,2,2017-11-07,rain,nan
182,81,101,2017-10-02,clear-day,nan
1344,687,657,2018-01-20,clear-day,nan
2640,1435,1205,2017-12-25,partly-cloudy-day,Christmas Day
1118,515,603,2017-11-28,clear-day,nan
1906,756,1150,2017-11-26,clear-day,nan
2211,1050,1161,2018-01-02,clear-day,nan
1371,619,752,2017-12-20,clear-day,nan
213,169,44,2018-01-31,clear-night,nan
708,368,340,2018-01-09,clear-day,nan
2,1,1,2018-01-13,rain,nan
16,6,10,2017-11-01,clear-night,nan
196,86,110,2017-12-04,partly-cloudy-night,nan
809,373,436,2017-12-13,clear-day,nan
168,82,86,2017-10-15,partly-cloudy-night,nan
6,2,4,2017-12-19,cloudy,nan
103,95,8,2017-12-17,partly-cloudy-night,nan
113,73,40,2017-11-22,rain,nan
21,17,4,2018-01-27,clear-night,nan
831,403,428,2018-01-15,partly-cloudy-day,Martin Luther King Jr. Day
3,2,1,2017-12-28,clear-night,nan
47,21,26,2017-10-30,rain,nan
1456,646,810,2017-11-17,clear-day,nan
7,4,3,2018-01-10,clear-night,nan
593,309,284,2018-02-02,partly-cloudy-day,nan
36,14,22,2017-12-04,clear-night,nan
1668,800,868,2017-12-22,partly-cloudy-day,nan
371,192,179,2017-10-28,clear-day,nan
8,7,1,2017-12-15,clear-night,nan
2375,1058,1317,2017-11-12,clear-day,nan
61,27,34,2017-12-10,partly-cloudy-night,nan
3,1,2,2018-01-08,partly-cloudy-night,nan
1661,699,962,2017-10-26,partly-cloudy-day,nan
17,12,5,2018-01-14,clear-night,nan
157,99,58,2017-11-20,clear-night,nan
1737,1037,700,2017-10-07,clear-day,nan
1567,755,812,2017-11-23,clear-day,Thanksgiving Day
16,9,7,2018-02-01,partly-cloudy-night,nan
574,343,231,2017-11-26,partly-cloudy-day,nan
105,63,42,2018-01-03,partly-cloudy-night,nan
4,2,2,2018-01-07,clear-night,nan
42,18,24,2017-10-26,partly-cloudy-night,nan
1174,539,635,2017-12-21,clear-day,nan
1310,659,651,2018-01-27,clear-day,nan
442,260,182,2017-12-29,partly-cloudy-day,nan
144,65,79,2017-12-01,clear-night,nan
1,0,1,2017-12-22,partly-cloudy-night,nan
754,352,402,2018-01-05,clear-day,nan
219,153,66,2017-11-13,clear-night,nan
33,21,12,2018-01-21,cloudy,nan
911,374,537,2017-12-02,clear-night,nan
491,247,244,2018-01-16,partly-cloudy-day,nan
33,17,16,2017-11-06,partly-cloudy-night,nan
146,106,40,2017-12-12,partly-cloudy-night,nan
3006,1277,1729,2017-10-01,clear-day,nan
998,475,523,2017-11-29,clear-day,nan
2484,1115,1369,2017-12-02,clear-day,nan
247,116,131,2017-10-31,clear-night,Halloween
28,14,14,2017-10-04,clear-night,nan
14,10,4,2017-12-06,partly-cloudy-night,nan
160,90,70,2017-10-08,partly-cloudy-night,nan
1106,526,580,2017-11-15,partly-cloudy-day,nan
282,134,148,2017-11-10,clear-night,Veterans Day observed
1410,630,780,2017-11-17,clear-day,nan
5,3,2,2017-10-17,clear-night,nan
1582,701,881,2018-01-13,clear-day,nan
715,464,251,2017-12-09,fog,nan
73,53,20,2017-12-14,clear-night,nan
70,55,15,2018-02-04,cloudy,nan
0,0,0,2018-01-28,partly-cloudy-night,nan
96,74,22,2018-01-31,clear-night,nan
362,143,219,2018-01-22,partly-cloudy-day,nan
96,73,23,2017-11-12,clear-night,nan
607,329,278,2018-01-22,partly-cloudy-day,nan
1572,651,921,2017-12-11,clear-day,nan
2612,1361,1251,2017-12-24,clear-day,Christmas Eve
514,244,270,2018-01-31,clear-day,nan
8,5,3,2017-10-14,partly-cloudy-night,nan
2021,1010,1011,2017-10-19,clear-day,nan
931,499,432,2017-10-24,partly-cloudy-night,nan
3,2,1,2017-11-27,clear-night,nan
455,245,210,2017-10-25,partly-cloudy-night,nan
840,397,443,2018-01-29,clear-day,nan
403,212,191,2017-12-18,partly-cloudy-day,nan
93,89,4,2018-01-25,clear-night,nan
28,17,11,2017-11-23,clear-night,Thanksgiving Day
1871,911,960,2017-10-26,partly-cloudy-day,nan
2308,1030,1278,2018-01-27,clear-day,nan
135,69,66,2017-10-06,clear-night,nan
3609,1805,1804,2017-10-21,clear-day,nan
57,33,24,2018-02-03,clear-night,nan
773,319,454,2017-10-02,clear-night,nan
793,451,342,2018-01-03,clear-day,nan
1506,705,801,2017-11-06,partly-cloudy-day,nan
609,322,287,2018-01-16,partly-cloudy-day,nan
213,116,97,2017-11-05,partly-cloudy-night,Daylight Saving Time ends
1867,805,1062,2017-11-21,clear-day,nan
71,37,34,2017-11-11,clear-day,Veterans Day
412,191,221,2017-12-07,clear-day,nan
134,84,50,2018-01-28,partly-cloudy-day,nan
316,203,113,2018-01-28,partly-cloudy-night,nan
260,193,67,2017-12-20,clear-night,nan
745,399,346,2018-01-10,clear-day,nan
15,12,3,2017-11-05,partly-cloudy-night,Daylight Saving Time ends
15,8,7,2018-01-24,clear-night,nan
22,12,10,2017-11-29,clear-night,nan
79,45,34,2017-12-23,partly-cloudy-night,nan
132,105,27,2018-01-30,partly-cloudy-night,nan
1116,694,422,2017-10-11,clear-day,nan
665,351,314,2017-10-20,clear-day,nan
1907,1016,891,2017-10-10,clear-day,nan
1741,868,873,2017-12-16,partly-cloudy-day,nan
446,256,190,2018-01-11,partly-cloudy-day,nan
13,8,5,2017-10-27,clear-night,nan
363,201,162,2018-01-18,clear-day,nan
217,152,65,2017-12-19,clear-night,nan
355,173,182,2017-11-24,clear-night,Black Friday
895,423,472,2017-12-08,clear-night,nan
1324,601,723,2017-10-19,clear-day,nan
5,3,2,2018-01-07,clear-night,nan
4,2,2,2017-11-15,partly-cloudy-night,nan
76,27,49,2018-01-12,partly-cloudy-night,nan
12,7,5,2017-12-27,clear-night,nan
396,260,136,2017-11-30,clear-night,nan
2,0,2,2017-12-25,partly-cloudy-night,Christmas Day
3,0,3,2017-10-05,partly-cloudy-night,nan
499,282,217,2018-01-26,clear-day,nan
4,3,1,2017-11-19,partly-cloudy-night,nan
168,126,42,2017-12-21,clear-night,nan
1,1,0,2017-10-16,partly-cloudy-night,nan
4,1,3,2017-10-24,partly-cloudy-night,nan
228,142,86,2017-11-08,partly-cloudy-night,nan
5,4,1,2017-12-10,clear-night,nan
2125,1104,1021,2017-10-23,partly-cloudy-day,nan
18,11,7,2018-01-29,clear-night,nan
197,103,94,2018-01-21,clear-day,nan
1080,485,595,2017-12-04,clear-night,nan
1524,874,650,2017-10-04,clear-day,nan
12,5,7,2017-12-21,clear-night,nan
19,9,10,2017-10-21,clear-night,nan
825,375,450,2017-10-09,partly-cloudy-day,Columbus Day (regional holiday)
788,413,375,2018-01-28,partly-cloudy-day,nan
93,56,37,2018-01-26,clear-night,nan
152,78,74,2017-10-28,partly-cloudy-night,nan
255,150,105,2017-12-15,fog,nan
220,61,159,2018-02-01,partly-cloudy-day,nan
7,6,1,2017-11-18,clear-night,nan
2070,1040,1030,2017-12-26,clear-day,nan
34,24,10,2017-11-25,clear-night,nan
892,528,364,2017-12-16,partly-cloudy-day,nan
963,487,476,2017-12-19,clear-night,nan
8,6,2,2018-01-05,clear-night,nan
1046,486,560,2017-11-10,clear-day,Veterans Day observed
247,157,90,2017-12-16,partly-cloudy-night,nan
110,70,40,2017-10-29,rain,nan
966,375,591,2017-11-07,partly-cloudy-day,nan
402,183,219,2017-10-22,clear-night,nan
988,536,452,2017-12-31,clear-day,New Year's Eve
23,15,8,2017-10-25,partly-cloudy-night,nan
95,28,67,2018-01-06,clear-night,nan
3600,1858,1742,2017-10-21,clear-day,nan
90,35,55,2017-12-08,partly-cloudy-night,nan
270,200,70,2017-11-28,clear-night,nan
87,35,52,2018-01-01,clear-night,New Year's Day
19,12,7,2017-12-03,partly-cloudy-night,nan
134,92,42,2018-01-17,partly-cloudy-night,nan
31,15,16,2018-01-05,clear-night,nan
1870,931,939,2017-11-01,partly-cloudy-day,nan
6,4,2,2017-12-14,partly-cloudy-night,nan
1669,736,933,2017-11-20,clear-day,nan
0,0,0,2017-11-07,clear-night,nan
29,9,20,2018-01-01,clear-night,New Year's Day
14,9,5,2017-10-10,partly-cloudy-night,nan
132,108,24,2017-11-16,clear-night,nan
38,18,20,2018-01-23,rain,nan
31,15,16,2018-02-02,clear-night,nan
291,103,188,2017-11-30,clear-day,nan
133,91,42,2018-01-12,cloudy,nan
338,126,212,2017-10-05,partly-cloudy-day,nan
0,0,0,2017-12-31,clear-night,New Year's Eve
2043,918,1125,2017-11-19,partly-cloudy-day,nan
54,34,20,2017-12-27,clear-night,nan
8,5,3,2017-11-12,clear-night,nan
66,43,23,2017-11-27,clear-night,nan
2,0,2,2018-01-05,partly-cloudy-night,nan
481,251,230,2018-01-30,partly-cloudy-day,nan
617,302,315,2018-01-06,clear-day,nan
957,365,592,2017-12-05,partly-cloudy-day,nan
1146,457,689,2017-11-23,clear-night,Thanksgiving Day
425,156,269,2017-10-16,clear-day,nan
9,5,4,2017-11-05,partly-cloudy-night,Daylight Saving Time ends
585,230,355,2018-01-01,clear-night,New Year's Day
1201,513,688,2017-11-30,partly-cloudy-day,nan
3,2,1,2018-01-19,clear-night,nan
609,300,309,2017-12-17,clear-night,nan
106,54,52,2017-12-26,clear-night,nan
385,261,124,2018-01-19,clear-night,nan
817,394,423,2018-01-24,partly-cloudy-day,nan
62,34,28,2017-12-12,partly-cloudy-night,nan
162,49,113,2018-01-25,clear-day,nan
90,34,56,2017-12-15,clear-night,nan
2,2,0,2017-11-02,cloudy,nan
1,0,1,2018-01-30,partly-cloudy-night,nan
6,4,2,2017-11-16,partly-cloudy-night,nan
725,281,444,2018-02-04,partly-cloudy-day,nan
5,3,2,2017-12-23,partly-cloudy-night,nan
0,0,0,2017-11-23,clear-night,Thanksgiving Day
18,11,7,2018-01-16,partly-cloudy-night,nan
71,36,35,2017-12-06,partly-cloudy-night,nan
1701,730,971,2017-12-08,clear-day,nan
139,82,57,2018-01-10,partly-cloudy-night,nan
56,35,21,2017-11-25,clear-night,nan
2131,1025,1106,2017-10-25,partly-cloudy-day,nan
20,10,10,2017-11-22,partly-cloudy-night,nan
6,3,3,2017-10-30,partly-cloudy-night,nan
257,115,142,2018-01-21,partly-cloudy-night,nan
16,9,7,2017-11-10,partly-cloudy-night,Veterans Day observed
193,99,94,2017-11-03,wind,nan
635,307,328,2018-02-02,partly-cloudy-day,nan
956,476,480,2017-11-27,clear-night,nan
4,3,1,2018-01-17,partly-cloudy-night,nan
965,484,481,2017-12-11,clear-night,nan
4,2,2,2017-11-10,clear-night,Veterans Day observed
3229,1724,1505,2017-10-22,clear-day,nan
78,38,40,2017-12-30,cloudy,nan
1338,551,787,2018-01-03,clear-night,nan
1816,1026,790,2017-12-30,partly-cloudy-day,nan
1,0,1,2018-01-04,partly-cloudy-night,nan
656,312,344,2018-01-08,partly-cloudy-day,nan
204,109,95,2017-10-14,partly-cloudy-night,nan
1644,669,975,2017-12-01,clear-day,nan
427,250,177,2017-11-25,clear-night,nan
400,164,236,2017-11-07,clear-day,nan
1207,676,531,2017-12-27,partly-cloudy-day,nan
3,1,2,2017-11-01,clear-night,nan
96,64,32,2017-12-09,fog,nan
198,142,56,2018-01-27,clear-night,nan
155,71,84,2017-12-08,clear-night,nan
250,111,139,2018-01-27,clear-night,nan
79,42,37,2018-01-04,snow,nan
1883,1044,839,2017-10-02,clear-day,nan
270,143,127,2018-01-02,clear-night,nan
147,53,94,2017-12-19,cloudy,nan
32,15,17,2017-12-28,clear-night,nan
18,8,10,2018-01-09,clear-night,nan
447,248,199,2018-01-15,clear-day,Martin Luther King Jr. Day
2386,1237,1149,2017-10-13,partly-cloudy-day,nan
91,42,49,2017-11-14,partly-cloudy-night,nan
1052,553,499,2018-01-14,clear-day,nan
6,3,3,2017-10-02,clear-night,nan
345,150,195,2017-12-02,clear-night,nan
1069,546,523,2017-12-01,clear-night,nan
1257,828,429,2017-11-09,partly-cloudy-day,nan
200,154,46,2017-11-15,partly-cloudy-night,nan
615,371,244,2017-10-11,partly-cloudy-day,nan
3251,1765,1486,2017-10-07,clear-day,nan
6,4,2,2017-10-28,clear-night,nan
2904,1390,1514,2017-10-15,partly-cloudy-day,nan
1005,458,547,2018-01-26,clear-day,nan
81,45,36,2017-10-17,clear-night,nan
0,0,0,2018-01-26,clear-night,nan
229,164,65,2017-12-07,partly-cloudy-night,nan
1745,858,887,2017-10-08,partly-cloudy-day,nan
255,145,110,2017-12-23,rain,nan
619,424,195,2017-12-12,partly-cloudy-night,nan
230,96,134,2017-10-03,clear-day,nan
1072,593,479,2017-12-24,clear-day,Christmas Eve
1382,787,595,2017-10-05,partly-cloudy-day,nan
347,145,202,2017-10-27,clear-day,nan
237,174,63,2018-02-01,cloudy,nan
32,22,10,2017-12-17,partly-cloudy-night,nan
1641,983,658,2017-10-17,clear-day,nan
375,216,159,2018-01-17,partly-cloudy-day,nan
11,6,5,2017-10-08,partly-cloudy-night,nan
115,58,57,2018-01-10,clear-night,nan
759,275,484,2017-10-06,clear-night,nan
5,2,3,2018-02-03,clear-night,nan
316,225,91,2017-11-21,clear-night,nan
7,1,6,2018-01-24,partly-cloudy-night,nan
25,13,12,2017-12-15,partly-cloudy-night,nan
1737,907,830,2017-12-03,partly-cloudy-day,nan
561,300,261,2017-12-28,clear-night,nan
2304,1135,1169,2017-10-31,partly-cloudy-day,Halloween
1050,681,369,2017-10-18,clear-day,nan
1254,552,702,2017-11-02,clear-night,nan
2254,1090,1164,2017-11-02,clear-day,nan
20,14,6,2018-01-14,clear-night,nan
1218,573,645,2018-01-09,clear-day,nan
104,68,36,2017-10-01,clear-night,nan
1459,771,688,2017-11-11,clear-day,Veterans Day
172,128,44,2017-12-04,partly-cloudy-night,nan
57,32,25,2018-01-31,clear-night,nan
2366,1166,1200,2017-12-29,clear-day,nan
18,12,6,2018-01-03,partly-cloudy-night,nan
290,218,72,2018-01-08,partly-cloudy-night,nan
48,32,16,2018-01-10,partly-cloudy-night,nan
747,352,395,2018-01-31,partly-cloudy-day,nan
421,195,226,2017-12-23,partly-cloudy-night,nan
261,133,128,2017-10-01,clear-day,nan
1860,876,984,2017-12-17,partly-cloudy-day,nan
12,5,7,2017-10-04,clear-night,nan
108,50,58,2017-11-12,clear-night,nan
2,1,1,2018-02-01,partly-cloudy-night,nan
1,0,1,2017-12-02,clear-night,nan
555,360,195,2017-12-10,clear-day,nan
1249,539,710,2017-12-26,clear-night,nan
117,39,78,2018-01-08,clear-day,nan
6,2,4,2018-01-12,partly-cloudy-night,nan
1,0,1,2018-01-25,clear-night,nan
1773,1016,757,2017-10-24,partly-cloudy-day,nan
608,288,320,2018-01-25,clear-day,nan
16,9,7,2017-10-13,clear-night,nan
58,16,42,2017-10-05,partly-cloudy-night,nan
936,555,381,2017-10-03,clear-day,nan
3,2,1,2017-11-08,partly-cloudy-night,nan
1095,583,512,2017-10-16,clear-day,nan
776,248,528,2017-10-10,clear-night,nan
100,60,40,2017-10-11,clear-night,nan
128,28,100,2018-01-30,partly-cloudy-day,nan
18,7,11,2018-01-08,cloudy,nan
5,4,1,2017-12-25,cloudy,Christmas Day
18,9,9,2017-10-19,clear-night,nan
57,40,17,2017-10-22,clear-night,nan
151,46,105,2018-01-19,clear-day,nan
12,7,5,2017-12-14,partly-cloudy-night,nan
787,414,373,2017-10-09,partly-cloudy-day,Columbus Day (regional holiday)
645,278,367,2017-10-28,clear-night,nan
70,35,35,2017-11-23,clear-night,Thanksgiving Day
1040,516,524,2018-01-11,cloudy,nan
32,15,17,2017-11-30,clear-night,nan
653,264,389,2017-11-08,partly-cloudy-night,nan
5,1,4,2018-01-06,clear-night,nan
2044,935,1109,2017-11-24,clear-day,Black Friday
1826,900,926,2017-12-31,clear-day,New Year's Eve
152,45,107,2018-01-16,partly-cloudy-day,nan
3,1,2,2017-12-26,clear-night,nan
3,2,1,2017-12-11,cloudy,nan
1067,396,671,2017-11-19,clear-night,nan
204,142,62,2017-11-14,partly-cloudy-night,nan
201,96,105,2017-10-20,clear-night,nan
263,173,90,2018-01-07,clear-day,nan
4,0,4,2017-12-30,clear-night,nan
2224,1023,1201,2018-01-20,clear-day,nan
57,30,27,2017-12-30,partly-cloudy-night,nan
1509,675,834,2017-11-20,partly-cloudy-day,nan
121,106,15,2017-12-06,clear-night,nan
413,168,245,2017-11-01,partly-cloudy-night,nan
278,106,172,2017-10-12,partly-cloudy-day,nan
46,22,24,2017-10-16,clear-night,nan
68,46,22,2017-12-03,partly-cloudy-night,nan
1373,660,713,2017-11-07,partly-cloudy-day,nan
8,2,6,2017-12-09,partly-cloudy-night,nan
49,27,22,2018-01-29,cloudy,nan
154,73,81,2017-12-28,clear-day,nan
129,72,57,2017-12-27,cloudy,nan
3235,1540,1695,2017-11-04,clear-day,nan
520,240,280,2017-10-29,rain,nan
97,36,61,2018-01-01,clear-night,New Year's Day
1509,904,605,2017-10-15,partly-cloudy-day,nan
205,129,76,2017-12-18,partly-cloudy-night,nan
141,80,61,2018-01-04,snow,nan
192,73,119,2017-12-24,cloudy,Christmas Eve
2347,1024,1323,2017-11-24,clear-day,Black Friday
664,304,360,2018-01-05,clear-day,nan
1,0,1,2018-01-23,cloudy,nan
216,105,111,2017-10-23,partly-cloudy-night,nan
80,57,23,2018-01-12,rain,nan
3,2,1,2017-11-30,clear-night,nan
3,1,2,2017-11-30,clear-night,nan
519,250,269,2018-01-30,partly-cloudy-day,nan
94,41,53,2018-01-18,clear-night,nan
13,9,4,2017-12-23,partly-cloudy-night,nan
181,110,71,2018-01-24,clear-night,nan
542,201,341,2017-10-23,partly-cloudy-day,nan
2,0,2,2017-12-24,clear-night,Christmas Eve
1017,621,396,2017-10-04,clear-day,nan
827,408,419,2017-11-13,partly-cloudy-day,nan
279,130,149,2017-10-30,clear-night,nan
117,42,75,2017-10-09,partly-cloudy-night,Columbus Day (regional holiday)
442,257,185,2017-11-18,clear-day,nan
77,45,32,2017-12-07,clear-night,nan
44,19,25,2018-01-09,clear-night,nan
405,168,237,2017-11-03,partly-cloudy-day,nan
61,33,28,2017-10-12,clear-night,nan
928,515,413,2017-11-16,partly-cloudy-day,nan
1534,722,812,2017-12-19,partly-cloudy-day,nan
263,150,113,2017-12-23,rain,nan
16,10,6,2017-12-29,partly-cloudy-night,nan
3,2,1,2018-01-31,clear-night,nan
1784,896,888,2017-12-28,clear-day,nan
484,317,167,2018-01-01,clear-day,New Year's Day
4,1,3,2018-01-03,clear-night,nan
25,11,14,2017-11-17,partly-cloudy-night,nan
244,109,135,2017-10-07,partly-cloudy-night,nan
17,9,8,2018-01-07,partly-cloudy-night,nan
2159,1114,1045,2017-10-13,partly-cloudy-day,nan
3,1,2,2017-11-26,partly-cloudy-night,nan
2265,1027,1238,2017-11-11,clear-day,Veterans Day
34,12,22,2018-01-04,fog,nan
212,102,110,2017-10-26,clear-night,nan
1003,543,460,2017-12-08,clear-day,nan
2185,1063,1122,2017-12-27,clear-day,nan
365,122,243,2017-11-01,cloudy,nan
157,131,26,2017-12-03,partly-cloudy-night,nan
149,124,25,2017-12-13,partly-cloudy-night,nan
8,2,6,2018-01-04,partly-cloudy-night,nan
50,23,27,2018-01-13,clear-night,nan
357,179,178,2018-01-20,clear-night,nan
1976,1025,951,2017-10-19,clear-day,nan
7,5,2,2017-10-14,partly-cloudy-night,nan
113,63,50,2017-12-11,partly-cloudy-night,nan
185,94,91,2017-11-23,clear-day,Thanksgiving Day
341,245,96,2017-12-05,partly-cloudy-night,nan
1480,596,884,2017-12-21,clear-day,nan
154,56,98,2018-01-08,clear-day,nan
25,15,10,2017-12-09,partly-cloudy-night,nan
247,111,136,2017-12-29,clear-night,nan
1111,531,580,2018-01-14,clear-day,nan
28,13,15,2018-01-02,clear-night,nan
34,10,24,2017-10-19,clear-night,nan
2801,1364,1437,2017-11-04,clear-day,nan
4,3,1,2017-10-18,clear-night,nan
1756,829,927,2017-10-02,clear-day,nan
133,65,68,2017-11-10,partly-cloudy-day,Veterans Day observed
96,39,57,2018-02-02,partly-cloudy-night,nan
139,67,72,2018-01-22,partly-cloudy-night,nan
1748,810,938,2017-11-09,partly-cloudy-day,nan
840,415,425,2017-11-15,cloudy,nan
145,75,70,2017-10-08,partly-cloudy-night,nan
502,211,291,2017-11-04,clear-night,nan
139,69,70,2017-10-11,partly-cloudy-night,nan
217,169,48,2018-01-16,partly-cloudy-night,nan
29,17,12,2017-10-07,clear-night,nan
22,10,12,2017-11-21,clear-night,nan
2,0,2,2018-01-02,clear-night,nan
96,64,32,2017-10-02,clear-night,nan
1076,538,538,2017-12-04,clear-day,nan
5,3,2,2017-11-28,clear-night,nan
5,2,3,2017-10-03,clear-night,nan
880,447,433,2017-12-07,clear-night,nan
17,6,11,2017-11-04,clear-night,nan
5,3,2,2018-01-14,clear-night,nan
422,189,233,2017-12-06,clear-day,nan
1254,573,681,2017-11-27,clear-day,nan
229,137,92,2018-01-17,partly-cloudy-day,nan
57,49,8,2018-01-31,clear-night,nan
147,74,73,2017-10-17,clear-night,nan
2,1,1,2017-12-18,partly-cloudy-night,nan
128,57,71,2018-01-26,clear-night,nan
7,5,2,2018-01-23,fog,nan
1087,584,503,2017-11-05,cloudy,Daylight Saving Time ends
311,129,182,2017-10-08,clear-night,nan
922,492,430,2017-12-23,partly-cloudy-day,nan
110,54,56,2017-11-24,clear-day,Black Friday
533,279,254,2017-12-22,partly-cloudy-night,nan
1865,853,1012,2017-12-03,partly-cloudy-day,nan
2606,1376,1230,2017-10-08,partly-cloudy-day,nan
899,298,601,2017-10-01,clear-night,nan
170,101,69,2017-11-17,clear-night,nan
185,113,72,2017-12-09,fog,nan
1580,788,792,2017-10-18,clear-day,nan
40,27,13,2017-11-22,clear-night,nan
168,82,86,2017-11-02,clear-night,nan
1145,682,463,2017-12-25,clear-day,Christmas Day
6,3,3,2017-11-06,partly-cloudy-night,nan
16,6,10,2017-12-13,clear-night,nan
360,153,207,2017-10-12,partly-cloudy-day,nan
225,69,156,2018-01-24,partly-cloudy-day,nan
12,8,4,2017-11-06,partly-cloudy-night,nan
1796,850,946,2017-12-01,clear-day,nan
2001,941,1060,2017-10-16,clear-day,nan
5,3,2,2017-10-26,partly-cloudy-night,nan
2094,1023,1071,2017-10-31,clear-day,Halloween
1975,785,1190,2017-10-24,partly-cloudy-day,nan
180,156,24,2018-01-18,clear-night,nan
1337,691,646,2018-02-03,clear-day,nan
2344,1256,1088,2017-10-13,partly-cloudy-day,nan
258,198,60,2017-11-29,clear-night,nan
1280,611,669,2017-12-17,cloudy,nan
722,348,374,2017-10-09,partly-cloudy-day,Columbus Day (regional holiday)
642,272,370,2018-01-23,partly-cloudy-day,nan
677,348,329,2018-01-25,clear-day,nan
3047,1418,1629,2017-10-14,partly-cloudy-day,nan
1644,923,721,2017-10-05,clear-day,nan
77,30,47,2017-10-10,clear-night,nan
9,3,6,2017-10-11,clear-night,nan
18,10,8,2017-10-01,partly-cloudy-night,nan
92,53,39,2017-10-13,partly-cloudy-night,nan
831,354,477,2017-12-31,clear-night,New Year's Eve
126,74,52,2017-10-06,clear-night,nan
121,86,35,2017-11-08,partly-cloudy-night,nan
666,404,262,2017-11-03,clear-day,nan
171,83,88,2017-12-22,clear-night,nan
2083,1122,961,2017-10-06,clear-day,nan
318,163,155,2017-11-26,clear-night,nan
757,291,466,2017-11-24,clear-night,Black Friday
14,11,3,2017-10-15,partly-cloudy-night,nan
533,250,283,2017-12-15,fog,nan
210,106,104,2017-12-02,clear-night,nan
29,16,13,2017-12-09,partly-cloudy-night,nan
5,3,2,2018-01-06,clear-night,nan
4,3,1,2017-12-31,partly-cloudy-night,New Year's Eve
20,15,5,2017-10-22,clear-night,nan
1,1,0,2017-10-12,partly-cloudy-night,nan
196,87,109,2017-10-15,partly-cloudy-night,nan
291,125,166,2017-10-04,clear-night,nan
2384,1245,1139,2017-11-03,clear-day,nan
7,2,5,2017-10-09,clear-night,Columbus Day (regional holiday)
113,70,43,2018-01-23,rain,nan
29,16,13,2017-10-19,clear-night,nan
3390,1556,1834,2017-11-25,clear-day,nan
2239,1014,1225,2017-12-10,clear-day,nan
17,8,9,2017-12-26,clear-night,nan
3,0,3,2018-01-16,partly-cloudy-night,nan
10,5,5,2017-12-05,partly-cloudy-night,nan
1844,792,1052,2018-01-21,partly-cloudy-day,nan
107,55,52,2017-11-18,partly-cloudy-night,nan
571,316,255,2017-11-07,clear-day,nan
1409,731,678,2017-10-20,clear-day,nan
561,361,200,2017-11-28,clear-night,nan
57,30,27,2017-11-01,cloudy,nan
517,202,315,2018-01-09,clear-night,nan
16,9,7,2017-11-14,clear-night,nan
954,402,552,2017-12-14,clear-day,nan
3750,1758,1992,2017-10-28,clear-day,nan
861,445,416,2018-01-07,clear-day,nan
14,9,5,2017-11-13,clear-night,nan
198,83,115,2018-02-01,partly-cloudy-day,nan
2226,1040,1186,2017-11-23,clear-day,Thanksgiving Day
57,27,30,2017-12-11,partly-cloudy-night,nan
1495,833,662,2017-10-17,clear-day,nan
165,101,64,2017-11-19,partly-cloudy-night,nan
168,87,81,2018-01-30,partly-cloudy-day,nan
3,2,1,2017-12-27,partly-cloudy-night,nan
5,2,3,2018-01-09,clear-night,nan
5,1,4,2018-01-22,partly-cloudy-night,nan
465,296,169,2017-12-18,partly-cloudy-night,nan
7,3,4,2018-02-04,partly-cloudy-night,nan
2792,1508,1284,2017-11-04,clear-day,nan
2325,1386,939,2018-01-01,clear-day,New Year's Day
113,100,13,2017-11-10,partly-cloudy-night,Veterans Day observed
2150,1126,1024,2017-10-27,clear-day,nan
544,280,264,2018-01-25,clear-day,nan
555,254,301,2017-12-01,clear-day,nan
1,0,1,2018-01-18,clear-night,nan
5,3,2,2017-10-23,partly-cloudy-night,nan
408,197,211,2017-11-14,partly-cloudy-day,nan
6,2,4,2017-12-25,cloudy,Christmas Day
11,8,3,2017-10-30,rain,nan
25,7,18,2017-10-31,clear-night,Halloween
611,313,298,2018-01-06,clear-day,nan
3,3,0,2018-01-20,clear-night,nan
1900,782,1118,2017-11-18,clear-day,nan
8,7,1,2018-02-04,rain,nan
411,0,0,2017-11-09,partly-cloudy-night,nan
3,0,3,2017-12-24,clear-night,Christmas Eve
26,15,11,2017-11-26,partly-cloudy-night,nan
31,14,17,2017-12-25,clear-night,Christmas Day
3,2,1,2017-12-07,partly-cloudy-night,nan
181,85,96,2017-10-04,clear-night,nan
828,315,513,2018-01-19,clear-day,nan
66,64,2,2018-01-24,clear-night,nan
5,2,3,2017-11-03,clear-night,nan
606,246,360,2017-10-12,clear-night,nan
80,38,42,2017-11-06,partly-cloudy-night,nan
935,414,521,2017-12-12,partly-cloudy-day,nan
3,0,3,2018-01-15,partly-cloudy-night,Martin Luther King Jr. Day
1230,613,617,2017-11-08,partly-cloudy-day,nan
283,128,155,2017-10-18,clear-night,nan
1112,508,604,2017-11-15,clear-day,nan
651,374,277,2017-12-20,partly-cloudy-day,nan
1454,757,697,2017-10-17,clear-day,nan
26,15,11,2017-10-27,clear-night,nan
0,0,0,2018-01-07,clear-night,nan
112,61,51,2017-11-04,cloudy,nan
350,131,219,2017-10-31,clear-day,Halloween
179,70,109,2017-10-31,clear-night,Halloween
1801,860,941,2017-11-21,clear-day,nan
14,6,8,2018-01-13,partly-cloudy-night,nan
403,243,160,2018-01-02,clear-day,nan
6,4,2,2017-11-11,clear-night,Veterans Day
2028,1069,959,2017-12-28,clear-day,nan
126,110,16,2017-12-29,clear-night,nan
0,0,0,2018-01-26,partly-cloudy-night,nan
289,158,131,2017-11-26,clear-day,nan
263,189,74,2018-01-22,partly-cloudy-night,nan
360,143,217,2017-10-20,clear-day,nan
1,0,1,2017-12-16,clear-night,nan
321,169,152,2017-12-22,partly-cloudy-day,nan
575,248,327,2017-10-14,partly-cloudy-night,nan
15,6,9,2017-11-17,partly-cloudy-night,nan
12,5,7,2018-02-04,partly-cloudy-night,nan
0,0,0,2017-12-16,clear-night,nan
1431,658,773,2017-11-22,partly-cloudy-day,nan
754,317,437,2018-02-01,clear-day,nan
27,11,16,2018-01-10,clear-night,nan
185,92,93,2017-11-22,partly-cloudy-night,nan
50,14,36,2017-10-24,partly-cloudy-night,nan
120,102,18,2017-11-18,clear-night,nan
536,195,341,2017-10-18,clear-night,nan
159,113,46,2018-01-25,clear-night,nan
420,238,182,2017-12-03,partly-cloudy-night,nan
164,86,78,2017-11-05,partly-cloudy-night,Daylight Saving Time ends
2514,1156,1358,2018-01-27,clear-day,nan
87,18,69,2018-01-17,partly-cloudy-day,nan
490,352,138,2018-01-29,partly-cloudy-night,nan
1364,619,745,2017-11-27,clear-day,nan
399,206,193,2018-01-12,rain,nan
23,9,14,2017-12-04,clear-night,nan
319,137,182,2017-10-25,partly-cloudy-night,nan
957,507,450,2017-11-27,clear-day,nan
37,34,3,2017-12-05,rain,nan
278,160,118,2018-01-03,snow,nan
3716,2316,1400,2017-11-12,partly-cloudy-day,nan
49,23,26,2017-10-23,clear-night,nan
240,167,73,2018-01-11,clear-night,nan
195,96,99,2017-12-22,partly-cloudy-day,nan
326,155,171,2017-10-27,clear-night,nan
1818,813,1005,2017-12-04,clear-day,nan
1827,806,1021,2017-11-26,clear-day,nan
5,4,1,2017-10-20,clear-night,nan
603,266,337,2018-01-16,partly-cloudy-day,nan
11,9,2,2017-11-07,rain,nan
199,102,97,2017-11-11,clear-day,Veterans Day
2629,1265,1364,2017-12-02,clear-day,nan
5,4,1,2017-12-20,partly-cloudy-night,nan
3,3,0,2017-10-31,clear-night,Halloween
202,149,53,2018-02-03,clear-night,nan
42,28,14,2017-11-04,clear-night,nan
1045,579,466,2018-01-13,partly-cloudy-day,nan
1593,893,700,2017-10-06,clear-day,nan
78,46,32,2017-10-02,clear-night,nan
2245,1189,1056,2017-10-01,clear-day,nan
20,10,10,2017-12-20,clear-night,nan
1132,373,759,2017-10-07,clear-night,nan
296,130,166,2017-10-09,partly-cloudy-day,Columbus Day (regional holiday)
205,116,89,2018-01-14,clear-night,nan
970,607,363,2017-11-05,cloudy,Daylight Saving Time ends
445,198,247,2017-12-11,clear-day,nan
341,160,181,2017-10-03,clear-night,nan
1291,452,839,2017-12-06,clear-day,nan
95,64,31,2018-01-20,clear-night,nan
56,21,35,2018-01-28,partly-cloudy-day,nan
56,37,19,2017-11-10,clear-night,Veterans Day observed
1642,762,880,2017-10-03,clear-day,nan
240,73,167,2017-12-18,cloudy,nan
1293,633,660,2017-11-29,clear-day,nan
226,113,113,2017-11-11,clear-night,Veterans Day
479,247,232,2017-10-08,partly-cloudy-day,nan
3,0,3,2017-11-24,clear-night,Black Friday
1883,943,940,2017-10-12,partly-cloudy-day,nan
86,49,37,2017-12-19,cloudy,nan
16,8,8,2017-10-29,rain,nan
463,228,235,2018-01-12,rain,nan
1678,811,867,2017-12-18,partly-cloudy-day,nan
1018,539,479,2018-01-21,clear-day,nan
1479,910,569,2017-10-19,clear-day,nan
223,108,115,2017-11-06,cloudy,nan
1336,502,834,2017-12-02,clear-night,nan
191,83,108,2017-11-28,clear-night,nan
2160,1069,1091,2018-01-03,clear-day,nan
1600,607,993,2017-12-07,clear-day,nan
984,518,466,2017-11-16,clear-day,nan
406,170,236,2017-10-21,clear-night,nan
86,40,46,2018-01-07,partly-cloudy-night,nan
537,248,289,2017-10-16,clear-day,nan
341,231,110,2017-10-26,clear-night,nan
5,1,4,2017-12-29,clear-night,nan
1739,1081,658,2017-10-04,clear-day,nan
1829,983,846,2017-10-05,partly-cloudy-day,nan
1351,671,680,2018-02-03,partly-cloudy-day,nan
2286,1130,1156,2017-11-25,clear-day,nan
1808,861,947,2017-10-11,clear-day,nan
2037,1087,950,2017-10-10,clear-day,nan
184,150,34,2017-12-06,clear-night,nan
319,239,80,2018-01-23,partly-cloudy-night,nan
2628,2191,437,2017-10-14,cloudy,nan
87,58,29,2017-10-21,clear-night,nan
169,81,88,2018-01-20,clear-day,nan
36,20,16,2018-01-28,clear-night,nan
10,6,4,2018-01-19,clear-night,nan
2004,1060,944,2017-11-03,clear-day,nan
27,8,19,2017-11-25,clear-night,nan
62,36,26,2017-10-15,partly-cloudy-night,nan
8,3,5,2017-10-06,partly-cloudy-night,nan
376,150,226,2018-01-05,clear-night,nan
200,107,93,2017-12-08,partly-cloudy-night,nan
2245,1176,1069,2017-10-20,clear-day,nan
17,10,7,2017-12-21,clear-night,nan
25,13,12,2017-11-26,clear-night,nan
0,0,0,2017-11-09,clear-night,nan
580,348,232,2017-12-21,clear-night,nan
149,65,84,2018-01-15,clear-night,Martin Luther King Jr. Day
9,5,4,2018-01-29,partly-cloudy-night,nan
1330,555,775,2017-10-15,cloudy,nan
1530,830,700,2017-10-04,clear-day,nan
87,57,30,2017-11-08,clear-night,nan
10,7,3,2017-12-21,clear-night,nan
8,5,3,2017-11-12,clear-night,nan
1319,664,655,2017-11-08,partly-cloudy-day,nan
404,301,103,2017-12-31,clear-night,New Year's Eve
263,126,137,2017-12-12,partly-cloudy-day,nan
13,7,6,2017-12-10,partly-cloudy-night,nan
125,55,70,2018-01-29,clear-night,nan
184,110,74,2017-11-19,partly-cloudy-day,nan
1062,576,486,2017-12-26,clear-day,nan
356,163,193,2017-10-13,partly-cloudy-night,nan
10,6,4,2018-01-21,clear-night,nan
67,56,11,2017-11-30,partly-cloudy-night,nan
4330,2150,2180,2017-10-28,clear-day,nan
23,16,7,2018-02-02,clear-night,nan
31,18,13,2017-12-05,partly-cloudy-night,nan
2391,1187,1204,2017-10-23,partly-cloudy-day,nan
11,5,6,2017-12-24,clear-night,Christmas Eve
277,158,119,2018-01-28,partly-cloudy-day,nan
22,14,8,2018-01-27,clear-night,nan
872,404,468,2018-01-10,clear-day,nan
123,114,9,2017-12-17,partly-cloudy-night,nan
282,156,126,2017-12-25,clear-night,Christmas Day
80,42,38,2017-10-09,partly-cloudy-night,Columbus Day (regional holiday)
828,383,445,2018-01-10,clear-day,nan
20,10,10,2018-01-02,clear-night,nan
15,9,6,2017-12-02,clear-night,nan
17,9,8,2017-11-13,partly-cloudy-night,nan
163,92,71,2018-01-04,partly-cloudy-night,nan
297,180,117,2017-11-02,clear-night,nan
507,236,271,2017-10-24,partly-cloudy-day,nan
24,11,13,2017-11-29,clear-night,nan
2679,1281,1398,2017-10-27,clear-day,nan
47,27,20,2018-01-17,partly-cloudy-night,nan
549,323,226,2017-12-13,clear-night,nan
219,163,56,2017-12-19,clear-night,nan
1484,861,623,2017-11-01,partly-cloudy-day,nan
5,5,0,2017-10-29,partly-cloudy-night,nan
10,8,2,2018-01-11,partly-cloudy-night,nan
916,450,466,2017-12-30,partly-cloudy-day,nan
8,4,4,2018-01-27,clear-night,nan
7,3,4,2018-01-06,clear-night,nan
2464,1519,945,2017-10-21,clear-day,nan
297,98,199,2017-11-15,clear-day,nan
510,266,244,2018-02-02,partly-cloudy-day,nan
46,28,18,2017-12-31,clear-night,New Year's Eve
1,0,1,2017-11-20,partly-cloudy-night,nan
400,213,187,2017-11-30,clear-day,nan
943,396,547,2017-12-15,clear-day,nan
669,360,309,2017-12-27,clear-night,nan
131,76,55,2017-10-10,clear-night,nan
43,20,23,2017-12-26,clear-night,nan
2241,1201,1040,2017-10-25,partly-cloudy-day,nan
3,2,1,2017-12-01,partly-cloudy-night,nan
6,5,1,2018-02-04,rain,nan
76,40,36,2018-01-11,clear-night,nan
3558,1763,1795,2017-10-21,clear-day,nan
150,68,82,2017-10-19,clear-night,nan
1321,609,712,2017-11-14,partly-cloudy-day,nan
3,2,1,2017-10-16,partly-cloudy-night,nan
1940,955,985,2017-10-30,partly-cloudy-day,nan
1960,1000,960,2017-10-10,clear-day,nan
1634,724,910,2017-12-19,clear-day,nan
1,0,1,2018-02-02,cloudy,nan
777,423,354,2018-02-04,partly-cloudy-day,nan
450,224,226,2017-11-06,clear-night,nan
655,337,318,2017-12-30,partly-cloudy-night,nan
2,1,1,2017-10-05,partly-cloudy-night,nan
979,450,529,2018-01-19,clear-day,nan
38,23,15,2017-11-12,clear-night,nan
11,7,4,2017-11-29,clear-night,nan
168,99,69,2017-12-17,partly-cloudy-night,nan
1213,506,707,2017-11-10,clear-day,Veterans Day observed
535,298,237,2018-01-24,partly-cloudy-day,nan
7,5,2,2018-05-06,partly-cloudy-night,nan
70,39,31,2018-03-03,partly-cloudy-night,nan
7,2,5,2018-03-14,clear-night,nan
16,13,3,2018-02-07,partly-cloudy-night,nan
2285,1037,1248,2018-05-07,partly-cloudy-day,nan
229,87,142,2018-06-10,cloudy,nan
3,1,2,2018-04-01,partly-cloudy-night,Easter Sunday
730,348,382,2018-04-15,cloudy,nan
13,8,5,2018-03-20,clear-night,nan
2567,1165,1402,2018-06-02,clear-day,nan
2478,1127,1351,2018-05-25,clear-day,nan
7,5,2,2018-04-12,partly-cloudy-night,nan
2083,848,1235,2018-04-08,partly-cloudy-day,nan
38,21,17,2018-05-18,clear-night,nan
888,331,557,2018-03-10,cloudy,nan
424,154,270,2018-04-24,clear-day,nan
2235,1004,1231,2018-04-01,clear-day,Easter Sunday
1297,628,669,2018-04-17,partly-cloudy-day,Tax Day
335,122,213,2018-05-03,clear-day,nan
527,247,280,2018-04-04,clear-night,nan
26,11,15,2018-03-03,partly-cloudy-night,nan
765,260,505,2018-05-24,clear-night,nan
1366,737,629,2018-03-19,clear-day,nan
37,23,14,2018-04-07,cloudy,nan
108,74,34,2018-02-20,fog,nan
759,432,327,2018-05-30,cloudy,nan
4,3,1,2018-04-03,clear-night,nan
119,96,23,2018-02-10,rain,nan
1176,694,482,2018-06-05,partly-cloudy-day,nan
148,115,33,2018-04-22,clear-night,nan
2515,1226,1289,2018-03-26,clear-day,nan
1767,681,1086,2018-03-25,partly-cloudy-day,nan
2610,1199,1411,2018-05-11,clear-day,nan
7,2,5,2018-05-12,partly-cloudy-night,nan
178,86,92,2018-06-12,clear-day,nan
860,445,415,2018-03-08,snow,nan
751,344,407,2018-05-13,rain,Mother's Day
56,36,20,2018-02-09,clear-night,nan
587,355,232,2018-05-13,partly-cloudy-day,Mother's Day
440,250,190,2018-06-10,partly-cloudy-day,nan
355,177,178,2018-05-03,partly-cloudy-night,nan
938,394,544,2018-05-04,partly-cloudy-night,nan
2031,913,1118,2018-04-06,partly-cloudy-day,nan
842,392,450,2018-04-30,partly-cloudy-day,nan
25,14,11,2018-04-14,clear-night,nan
786,424,362,2018-05-31,cloudy,nan
759,372,387,2018-05-02,clear-day,nan
669,363,306,2018-04-19,partly-cloudy-day,nan
7,5,2,2018-04-29,rain,nan
370,154,216,2018-05-10,partly-cloudy-day,nan
96,89,7,2018-02-25,partly-cloudy-night,nan
13,12,1,2018-04-11,clear-night,nan
6,3,3,2018-03-23,clear-night,nan
1518,696,822,2018-02-19,partly-cloudy-day,Presidents' Day (regional holiday)
6,4,2,2018-04-18,partly-cloudy-night,nan
558,224,334,2018-05-16,rain,nan
572,202,370,2018-06-04,partly-cloudy-night,nan
1699,711,988,2018-03-28,partly-cloudy-day,nan
123,58,65,2018-03-12,clear-night,nan
71,48,23,2018-03-14,partly-cloudy-night,nan
1378,739,639,2018-06-06,cloudy,nan
76,44,32,2018-02-18,clear-night,nan
4,0,4,2018-03-03,partly-cloudy-night,nan
20,15,5,2018-03-20,clear-night,nan
628,363,265,2018-02-15,partly-cloudy-day,nan
2247,972,1275,2018-05-18,cloudy,nan
1,0,1,2018-04-25,partly-cloudy-night,nan
57,37,20,2018-03-14,partly-cloudy-night,nan
2353,970,1383,2018-04-22,clear-day,nan
791,325,466,2018-03-31,clear-night,nan
15,13,2,2018-06-01,cloudy,nan
4,3,1,2018-05-24,clear-night,nan
1433,746,687,2018-02-26,clear-day,nan
4,1,3,2018-04-23,clear-night,nan
6,5,1,2018-05-20,fog,nan
2,0,2,2018-05-17,cloudy,nan
227,140,87,2018-05-19,rain,nan
0,0,0,2018-03-22,partly-cloudy-night,nan
1,1,0,2018-03-17,clear-night,St. Patrick's Day
3812,1826,1986,2018-04-28,clear-day,nan
2047,897,1150,2018-02-24,partly-cloudy-day,nan
319,155,164,2018-05-22,rain,nan
409,251,158,2018-02-14,clear-night,Valentine's Day
38,18,20,2018-05-22,clear-night,nan
80,48,32,2018-03-16,clear-night,nan
0,0,0,2018-02-05,partly-cloudy-night,nan
4,2,2,2018-03-26,clear-night,nan
4,2,2,2018-05-13,cloudy,Mother's Day
834,432,402,2018-03-09,partly-cloudy-day,nan
13,9,4,2018-02-28,clear-night,nan
405,238,167,2018-03-04,partly-cloudy-night,nan
1733,756,977,2018-04-21,clear-day,nan
55,21,34,2018-03-31,clear-night,nan
1028,536,492,2018-04-27,partly-cloudy-day,nan
189,75,114,2018-04-27,clear-day,nan
994,474,520,2018-02-08,partly-cloudy-day,nan
1110,470,640,2018-04-10,partly-cloudy-day,nan
12,6,6,2018-05-11,clear-night,nan
563,299,264,2018-04-10,partly-cloudy-day,nan
176,48,128,2018-03-23,clear-day,nan
11,4,7,2018-04-16,rain,nan
9,7,2,2018-02-25,partly-cloudy-night,nan
825,298,527,2018-02-19,partly-cloudy-day,Presidents' Day (regional holiday)
1564,817,747,2018-05-09,clear-day,nan
2205,945,1260,2018-05-14,partly-cloudy-day,nan
425,147,278,2018-04-23,clear-day,nan
1,0,1,2018-03-27,clear-night,nan
1787,832,955,2018-05-02,clear-day,nan
74,29,45,2018-04-18,partly-cloudy-night,nan
24,7,17,2018-02-22,cloudy,nan
1285,556,729,2018-03-17,clear-day,St. Patrick's Day
8,1,7,2018-02-12,clear-night,nan
1769,779,990,2018-03-27,clear-day,nan
283,185,98,2018-02-26,clear-night,nan
79,36,43,2018-03-25,clear-day,nan
28,14,14,2018-05-12,rain,nan
2840,1124,1716,2018-05-20,partly-cloudy-day,nan
169,84,85,2018-03-01,clear-day,nan
71,46,25,2018-06-09,clear-night,nan
163,63,100,2018-03-08,partly-cloudy-night,nan
32,20,12,2018-04-26,partly-cloudy-night,nan
123,73,50,2018-03-18,clear-night,nan
7,0,7,2018-05-08,clear-night,nan
192,95,97,2018-05-04,clear-day,nan
1859,861,998,2018-06-07,partly-cloudy-day,nan
1583,721,862,2018-04-12,clear-day,nan
1385,671,714,2018-04-04,partly-cloudy-day,nan
135,71,64,2018-02-09,clear-night,nan
1814,1017,797,2018-05-03,clear-day,nan
1258,593,665,2018-03-05,partly-cloudy-day,nan
208,86,122,2018-03-07,partly-cloudy-day,nan
694,340,354,2018-03-30,rain,nan
1775,866,909,2018-04-24,clear-day,nan
2,0,2,2018-02-14,partly-cloudy-night,Valentine's Day
1133,534,599,2018-02-16,partly-cloudy-day,nan
44,26,18,2018-05-09,clear-night,nan
211,101,110,2018-05-25,clear-day,nan
147,88,59,2018-03-21,snow,nan
23,14,9,2018-06-02,rain,nan
1035,497,538,2018-04-09,partly-cloudy-day,nan
48,39,9,2018-05-26,clear-night,nan
29,11,18,2018-05-20,cloudy,nan
123,58,65,2018-05-15,fog,nan
306,182,124,2018-05-15,rain,nan
53,34,19,2018-06-06,partly-cloudy-night,nan
185,111,74,2018-05-01,clear-night,nan
4,1,3,2018-04-06,clear-night,nan
1246,633,613,2018-05-31,cloudy,nan
672,410,262,2018-04-21,clear-day,nan
1899,709,1190,2018-05-26,clear-day,nan
1930,901,1029,2018-04-13,clear-day,nan
1359,684,675,2018-03-18,clear-day,nan
561,214,347,2018-05-21,clear-day,nan
2208,1156,1052,2018-06-11,clear-day,nan
15,4,11,2018-06-08,clear-night,nan
179,60,119,2018-05-23,clear-night,nan
739,440,299,2018-04-04,fog,nan
150,69,81,2018-04-05,clear-day,nan
16,7,9,2018-02-17,snow,nan
999,423,576,2018-06-07,clear-day,nan
1020,529,491,2018-04-11,clear-day,nan
860,327,533,2018-04-26,clear-night,nan
1824,974,850,2018-05-09,clear-day,nan
2,0,2,2018-03-07,partly-cloudy-night,nan
107,64,43,2018-03-21,snow,nan
73,36,37,2018-05-27,rain,nan
210,95,115,2018-04-10,partly-cloudy-day,nan
1825,896,929,2018-05-27,cloudy,nan
68,26,42,2018-04-29,partly-cloudy-night,nan
50,34,16,2018-02-05,clear-night,nan
6,1,5,2018-04-18,clear-night,nan
144,96,48,2018-03-13,partly-cloudy-day,nan
1928,841,1087,2018-06-10,partly-cloudy-day,nan
99,53,46,2018-03-27,clear-night,nan
148,109,39,2018-02-23,cloudy,nan
25,16,9,2018-02-10,clear-night,nan
1565,771,794,2018-05-03,clear-day,nan
10,8,2,2018-05-11,clear-night,nan
253,83,170,2018-02-15,partly-cloudy-day,nan
369,123,246,2018-04-12,clear-day,nan
6,2,4,2018-05-04,partly-cloudy-night,nan
77,33,44,2018-06-03,partly-cloudy-day,nan
3088,1564,1524,2018-03-24,clear-day,nan
416,249,167,2018-02-20,clear-night,nan
177,136,41,2018-03-29,cloudy,nan
739,392,347,2018-03-13,rain,nan
257,117,140,2018-02-23,cloudy,nan
190,100,90,2018-03-04,cloudy,nan
329,131,198,2018-02-26,clear-day,nan
35,25,10,2018-05-15,cloudy,nan
7,4,3,2018-04-28,partly-cloudy-night,nan
1642,794,848,2018-04-20,clear-day,nan
12,7,5,2018-06-03,partly-cloudy-night,nan
98,43,55,2018-04-09,partly-cloudy-night,nan
18,12,6,2018-03-02,rain,nan
370,222,148,2018-04-16,rain,nan
34,18,16,2018-02-16,partly-cloudy-night,nan
64,33,31,2018-03-05,partly-cloudy-night,nan
2167,1272,895,2018-03-31,clear-day,nan
993,482,511,2018-02-13,clear-day,nan
18,15,3,2018-03-01,rain,nan
119,54,65,2018-04-05,clear-night,nan
481,230,251,2018-03-20,clear-day,nan
52,19,33,2018-03-12,partly-cloudy-night,nan
75,38,37,2018-03-25,partly-cloudy-night,nan
90,53,37,2018-04-07,clear-night,nan
1072,617,455,2018-04-08,clear-day,nan
883,435,448,2018-02-05,clear-day,nan
2206,983,1223,2018-05-07,partly-cloudy-day,nan
2,1,1,2018-04-17,partly-cloudy-night,Tax Day
1333,585,748,2018-06-10,partly-cloudy-day,nan
7,5,2,2018-03-21,snow,nan
2006,911,1095,2018-04-20,clear-day,nan
2693,1196,1497,2018-04-05,clear-day,nan
812,351,461,2018-04-15,cloudy,nan
19,13,6,2018-04-13,clear-night,nan
6,4,2,2018-02-21,partly-cloudy-night,nan
4,3,1,2018-02-21,partly-cloudy-night,nan
127,45,82,2018-02-07,partly-cloudy-day,nan
81,72,9,2018-04-15,cloudy,nan
11,3,8,2018-06-12,clear-night,nan
1269,684,585,2018-03-24,clear-day,nan
1886,899,987,2018-05-24,clear-day,nan
182,92,90,2018-05-27,cloudy,nan
6,3,3,2018-04-19,cloudy,nan
4001,1975,2026,2018-03-31,clear-day,nan
97,49,48,2018-02-27,clear-night,nan
47,33,14,2018-06-10,partly-cloudy-night,nan
181,94,87,2018-04-30,partly-cloudy-night,nan
36,20,16,2018-02-27,clear-night,nan
96,91,5,2018-02-10,partly-cloudy-night,nan
65,36,29,2018-05-30,partly-cloudy-night,nan
1793,813,980,2018-06-06,cloudy,nan
713,246,467,2018-06-11,clear-night,nan
379,194,185,2018-04-18,cloudy,nan
617,249,368,2018-04-23,clear-night,nan
78,37,41,2018-02-25,cloudy,nan
26,12,14,2018-05-07,partly-cloudy-night,nan
1817,829,988,2018-03-25,partly-cloudy-day,nan
248,148,100,2018-04-29,partly-cloudy-day,nan
43,21,22,2018-03-10,clear-night,nan
1952,938,1014,2018-05-12,partly-cloudy-day,nan
272,187,85,2018-03-06,partly-cloudy-night,nan
38,18,20,2018-05-18,clear-night,nan
124,55,69,2018-06-07,cloudy,nan
9,5,4,2018-03-30,partly-cloudy-night,nan
113,57,56,2018-05-05,clear-day,Cinco de Mayo
1050,540,510,2018-05-17,partly-cloudy-day,nan
6,4,2,2018-04-24,clear-night,nan
27,9,18,2018-05-29,partly-cloudy-night,nan
800,377,423,2018-02-24,partly-cloudy-day,nan
743,418,325,2018-03-28,partly-cloudy-day,nan
171,131,40,2018-03-10,partly-cloudy-night,nan
298,174,124,2018-04-01,partly-cloudy-day,Easter Sunday
10,9,1,2018-05-19,cloudy,nan
2190,996,1194,2018-05-25,clear-day,nan
617,352,265,2018-05-06,cloudy,nan
1443,728,715,2018-03-29,cloudy,nan
9,4,5,2018-03-06,clear-night,nan
12,7,5,2018-04-26,partly-cloudy-night,nan
169,108,61,2018-04-28,rain,nan
2023,863,1160,2018-05-18,clear-day,nan
461,259,202,2018-04-19,partly-cloudy-day,nan
102,38,64,2018-04-01,clear-night,Easter Sunday
0,0,0,2018-03-08,clear-night,nan
7,1,6,2018-03-15,partly-cloudy-night,nan
980,596,384,2018-04-14,clear-day,nan
1989,896,1093,2018-05-23,partly-cloudy-day,nan
378,192,186,2018-06-05,clear-night,nan
858,421,437,2018-03-16,partly-cloudy-day,nan
67,22,45,2018-03-21,partly-cloudy-day,nan
719,297,422,2018-04-27,partly-cloudy-day,nan
2190,1008,1182,2018-06-03,partly-cloudy-day,nan
9,7,2,2018-02-19,clear-night,Presidents' Day (regional holiday)
1,0,1,2018-05-01,partly-cloudy-night,nan
1065,500,565,2018-02-27,clear-day,nan
568,357,211,2018-04-02,snow,nan
239,144,95,2018-02-11,rain,nan
2454,1353,1101,2018-05-05,clear-day,Cinco de Mayo
396,220,176,2018-04-08,partly-cloudy-night,nan
101,88,13,2018-03-27,partly-cloudy-night,nan
651,297,354,2018-03-15,partly-cloudy-night,nan
627,341,286,2018-05-14,partly-cloudy-day,nan
930,421,509,2018-04-06,partly-cloudy-day,nan
30,16,14,2018-03-04,partly-cloudy-night,nan
496,208,288,2018-05-23,partly-cloudy-day,nan
2176,996,1180,2018-03-11,clear-day,Daylight Saving Time starts
149,63,86,2018-02-12,partly-cloudy-day,nan
1170,590,580,2018-03-22,clear-day,nan
215,151,64,2018-02-21,rain,nan
162,62,100,2018-03-26,clear-night,nan
1216,514,702,2018-04-18,clear-day,nan
974,523,451,2018-03-14,clear-day,nan
751,375,376,2018-02-12,clear-night,nan
2463,1343,1120,2018-04-22,clear-day,nan
719,342,377,2018-05-08,clear-day,nan
92,51,41,2018-05-13,cloudy,Mother's Day
1352,642,710,2018-03-18,clear-day,nan
1903,915,988,2018-05-29,clear-day,nan
806,291,515,2018-06-08,partly-cloudy-night,nan
258,115,143,2018-05-01,clear-day,nan
209,102,107,2018-05-17,partly-cloudy-day,nan
432,251,181,2018-04-25,cloudy,nan
487,234,253,2018-05-19,cloudy,nan
551,283,268,2018-03-28,partly-cloudy-night,nan
20,0,20,2018-03-24,partly-cloudy-night,nan
11,9,2,2018-05-31,partly-cloudy-night,nan
53,31,22,2018-05-22,clear-night,nan
194,101,93,2018-04-20,clear-day,nan
284,206,78,2018-02-06,clear-night,nan
1539,929,610,2018-06-09,clear-day,nan
882,356,526,2018-05-08,clear-night,nan
9,8,1,2018-04-04,cloudy,nan
1166,552,614,2018-04-11,partly-cloudy-day,nan
1362,614,748,2018-03-09,partly-cloudy-day,nan
9,3,6,2018-04-06,clear-night,nan
1364,639,725,2018-03-06,clear-day,nan
43,21,22,2018-04-30,partly-cloudy-night,nan
11,8,3,2018-03-12,clear-night,nan
551,285,266,2018-02-22,partly-cloudy-day,nan
6,0,6,2018-02-06,clear-night,nan
1983,925,1058,2018-03-17,clear-day,St. Patrick's Day
76,44,32,2018-03-13,clear-night,nan
895,414,481,2018-03-20,partly-cloudy-day,nan
15,13,2,2018-02-17,clear-night,nan
100,50,50,2018-04-13,clear-night,nan
1099,457,642,2018-04-29,partly-cloudy-day,nan
2537,1213,1324,2018-04-26,clear-day,nan
1410,407,1003,2018-04-14,clear-day,nan
3435,1643,1792,2018-04-14,clear-day,nan
3,2,1,2018-04-26,rain,nan
284,115,169,2018-06-05,clear-day,nan
1701,882,819,2018-04-02,rain,nan
1064,576,488,2018-04-12,partly-cloudy-day,nan
215,136,79,2018-04-03,cloudy,nan
2000,899,1101,2018-02-17,partly-cloudy-day,nan
1550,805,745,2018-05-02,partly-cloudy-day,nan
185,93,92,2018-04-17,partly-cloudy-night,Tax Day
1900,938,962,2018-04-07,partly-cloudy-day,nan
536,359,177,2018-02-18,clear-day,nan
2153,986,1167,2018-05-06,partly-cloudy-day,nan
1149,572,577,2018-02-28,clear-day,nan
39,16,23,2018-04-02,clear-night,nan
799,267,532,2018-05-20,clear-night,nan
24,14,10,2018-05-16,partly-cloudy-night,nan
7,3,4,2018-05-02,clear-night,nan
1744,946,798,2018-06-02,clear-day,nan
797,439,358,2018-04-09,partly-cloudy-day,nan
61,43,18,2018-04-28,partly-cloudy-night,nan
2223,1131,1092,2018-06-02,clear-day,nan
19,15,4,2018-02-23,partly-cloudy-night,nan
6,0,6,2018-04-21,clear-night,nan
62,24,38,2018-05-05,partly-cloudy-night,Cinco de Mayo
842,371,471,2018-02-06,partly-cloudy-day,nan
97,44,53,2018-04-25,rain,nan
143,60,83,2018-04-09,clear-day,nan
1123,494,629,2018-03-29,cloudy,nan
39,19,20,2018-04-17,partly-cloudy-night,Tax Day
2611,1134,1477,2018-05-21,clear-day,nan
126,68,58,2018-05-16,partly-cloudy-day,nan
12,10,2,2018-03-28,partly-cloudy-night,nan
2110,1033,1077,2018-04-13,clear-day,nan
968,399,569,2018-04-07,partly-cloudy-day,nan
3,0,3,2018-02-06,clear-night,nan
202,59,143,2018-03-29,partly-cloudy-day,nan
1825,850,975,2018-06-04,partly-cloudy-day,nan
1690,742,948,2018-04-24,clear-day,nan
4,0,4,2018-03-04,partly-cloudy-night,nan
215,101,114,2018-06-08,clear-day,nan
722,411,311,2018-02-15,clear-night,nan
3025,1345,1680,2018-05-26,clear-day,nan
101,51,50,2018-02-21,cloudy,nan
543,273,270,2018-04-13,clear-night,nan
7,2,5,2018-02-07,clear-night,nan
21,15,6,2018-03-21,partly-cloudy-night,nan
1507,748,759,2018-04-04,partly-cloudy-day,nan
13,0,13,2018-03-07,partly-cloudy-night,nan
1891,623,1268,2018-03-30,partly-cloudy-day,nan
919,455,464,2018-02-05,clear-day,nan
78,43,35,2018-04-17,partly-cloudy-night,Tax Day
1961,935,1026,2018-05-24,clear-day,nan
23,11,12,2018-05-13,cloudy,Mother's Day
1702,810,892,2018-06-06,partly-cloudy-day,nan
119,54,65,2018-06-11,partly-cloudy-day,nan
435,250,185,2018-02-28,clear-night,nan
2072,984,1088,2018-04-20,clear-day,nan
2774,1220,1554,2018-04-05,partly-cloudy-day,nan
120,67,53,2018-05-30,clear-night,nan
183,83,100,2018-06-02,clear-day,nan
2670,1042,1628,2018-04-28,clear-day,nan
52,17,35,2018-05-01,partly-cloudy-night,nan
1487,800,687,2018-02-12,clear-day,nan
2595,1373,1222,2018-05-28,partly-cloudy-day,Memorial Day
284,124,160,2018-04-19,partly-cloudy-day,nan
4,2,2,2018-04-15,cloudy,nan
9,6,3,2018-03-31,partly-cloudy-night,nan
11,6,5,2018-05-27,partly-cloudy-night,nan
20,15,5,2018-03-07,partly-cloudy-night,nan
1396,502,894,2018-05-13,cloudy,Mother's Day
553,248,305,2018-03-09,partly-cloudy-night,nan
158,71,87,2018-06-11,clear-night,nan
1714,785,929,2018-05-10,partly-cloudy-day,nan
838,358,480,2018-05-30,partly-cloudy-day,nan
1567,719,848,2018-02-20,partly-cloudy-day,nan
8,4,4,2018-02-26,partly-cloudy-night,nan
30,14,16,2018-04-24,clear-night,nan
1041,483,558,2018-02-09,partly-cloudy-day,nan
580,180,400,2018-05-28,cloudy,Memorial Day
349,168,181,2018-04-25,rain,nan
33,18,15,2018-05-20,partly-cloudy-day,nan
2245,1160,1085,2018-04-01,clear-day,Easter Sunday
663,304,359,2018-05-17,clear-night,nan
1937,929,1008,2018-04-23,clear-day,nan
1449,639,810,2018-03-29,cloudy,nan
1227,672,555,2018-05-08,clear-day,nan
961,465,496,2018-03-01,clear-day,nan
4,2,2,2018-04-01,partly-cloudy-night,Easter Sunday
13,8,5,2018-03-02,partly-cloudy-night,nan
35,11,24,2018-03-11,clear-night,Daylight Saving Time starts
2,1,1,2018-04-09,clear-night,nan
1205,650,555,2018-05-10,partly-cloudy-day,nan
37,20,17,2018-03-15,clear-night,nan
153,72,81,2018-03-06,clear-day,nan
168,63,105,2018-03-08,clear-day,nan
1465,762,703,2018-03-10,partly-cloudy-day,nan
22,14,8,2018-02-10,partly-cloudy-night,nan
489,279,210,2018-02-19,clear-day,Presidents' Day (regional holiday)
1477,738,739,2018-05-27,cloudy,nan
24,15,9,2018-04-22,clear-night,nan
2969,1373,1596,2018-03-31,clear-day,nan
260,135,125,2018-03-30,partly-cloudy-day,nan
6,2,4,2018-05-07,partly-cloudy-night,nan
971,535,436,2018-04-11,partly-cloudy-day,nan
1718,745,973,2018-04-06,clear-day,nan
404,232,172,2018-05-22,partly-cloudy-day,nan
1182,608,574,2018-05-19,cloudy,nan
895,589,306,2018-04-22,clear-day,nan
1576,916,660,2018-06-05,partly-cloudy-day,nan
83,56,27,2018-03-15,clear-night,nan
71,47,24,2018-02-19,fog,Presidents' Day (regional holiday)
2251,1106,1145,2018-03-26,clear-day,nan
24,16,8,2018-04-29,partly-cloudy-night,nan
1267,608,659,2018-05-18,cloudy,nan
2125,1108,1017,2018-05-04,clear-day,nan
15,9,6,2018-02-13,clear-night,nan
117,60,57,2018-04-06,partly-cloudy-night,nan
0,0,0,2018-03-21,cloudy,nan
11,6,5,2018-03-24,clear-night,nan
1153,463,690,2018-06-11,clear-day,nan
1413,632,781,2018-03-16,partly-cloudy-day,nan
1433,901,532,2018-05-30,cloudy,nan
2,0,2,2018-05-23,rain,nan
33,21,12,2018-05-14,partly-cloudy-night,nan
1402,715,687,2018-02-27,clear-day,nan
7,5,2,2018-02-24,partly-cloudy-night,nan
310,172,138,2018-02-11,rain,nan
3277,1520,1757,2018-05-28,cloudy,Memorial Day
460,300,160,2018-04-10,partly-cloudy-day,nan
174,104,70,2018-05-16,cloudy,nan
1,0,1,2018-04-26,partly-cloudy-night,nan
0,0,0,2018-03-11,nan,Daylight Saving Time starts
7,5,2,2018-05-28,cloudy,Memorial Day
1441,632,809,2018-03-14,partly-cloudy-day,nan
351,120,231,2018-02-28,clear-day,nan
96,88,8,2018-04-21,clear-night,nan
11,7,4,2018-05-29,cloudy,nan
2147,990,1157,2018-03-03,partly-cloudy-day,nan
1411,637,774,2018-03-12,clear-day,nan
219,86,133,2018-04-24,partly-cloudy-night,nan
644,230,414,2018-04-03,partly-cloudy-day,nan
4,2,2,2018-06-04,rain,nan
1223,776,447,2018-05-06,partly-cloudy-day,nan
7,4,3,2018-05-16,partly-cloudy-night,nan
104,29,75,2018-03-22,partly-cloudy-day,nan
4,1,3,2018-04-09,clear-night,nan
46,26,20,2018-02-12,clear-night,nan
52,28,24,2018-02-05,clear-night,nan
493,207,286,2018-03-24,partly-cloudy-night,nan
58,8,50,2018-03-29,partly-cloudy-night,nan
1626,979,647,2018-05-01,clear-day,nan
478,215,263,2018-05-22,partly-cloudy-day,nan
61,22,39,2018-04-01,clear-night,Easter Sunday
13,7,6,2018-04-17,partly-cloudy-night,Tax Day
533,260,273,2018-02-22,partly-cloudy-day,nan
34,13,21,2018-03-13,snow,nan
738,344,394,2018-04-24,partly-cloudy-day,nan
316,125,191,2018-05-31,partly-cloudy-day,nan
2408,1107,1301,2018-04-07,partly-cloudy-day,nan
35,18,17,2018-02-06,clear-night,nan
22,11,11,2018-04-13,clear-night,nan
847,463,384,2018-03-17,clear-day,St. Patrick's Day
145,121,24,2018-02-08,clear-night,nan
186,66,120,2018-05-14,partly-cloudy-night,nan
18,7,11,2018-03-02,rain,nan
6,5,1,2018-04-02,partly-cloudy-night,nan
1406,664,742,2018-04-11,partly-cloudy-day,nan
55,31,24,2018-03-19,clear-night,nan
228,175,53,2018-02-16,clear-night,nan
2,1,1,2018-03-09,partly-cloudy-night,nan
1940,872,1068,2018-04-18,partly-cloudy-day,nan
126,45,81,2018-04-04,fog,nan
654,380,274,2018-03-13,clear-day,nan
254,108,146,2018-02-22,partly-cloudy-day,nan
1409,658,751,2018-03-23,clear-day,nan
1283,477,806,2018-05-25,clear-day,nan
11,6,5,2018-06-07,cloudy,nan
2420,1312,1108,2018-02-18,rain,nan
2187,1009,1178,2018-04-26,clear-day,nan
120,77,43,2018-02-11,rain,nan
458,243,215,2018-04-11,clear-day,nan
2127,928,1199,2018-06-10,cloudy,nan
34,6,28,2018-05-21,clear-night,nan
1520,888,632,2018-05-29,clear-day,nan
1059,439,620,2018-02-14,clear-day,Valentine's Day
218,123,95,2018-05-05,partly-cloudy-night,Cinco de Mayo
577,279,298,2018-04-30,partly-cloudy-day,nan
1894,1129,765,2018-04-14,clear-day,nan
10,5,5,2018-02-17,clear-night,nan
132,99,33,2018-04-19,clear-night,nan
468,253,215,2018-02-23,cloudy,nan
520,251,269,2018-05-11,partly-cloudy-night,nan
3321,1484,1837,2018-04-21,clear-day,nan
76,42,34,2018-04-08,clear-day,nan
120,50,70,2018-02-07,snow,nan
2854,1382,1472,2018-06-09,partly-cloudy-day,nan
1,0,1,2018-02-18,partly-cloudy-night,nan
859,400,459,2018-04-02,clear-day,nan
321,159,162,2018-04-27,partly-cloudy-night,nan
123,51,72,2018-02-08,partly-cloudy-night,nan
10,6,4,2018-04-24,clear-night,nan
6,3,3,2018-04-20,clear-night,nan
393,113,280,2018-06-03,partly-cloudy-night,nan
1738,758,980,2018-05-15,clear-day,nan
2457,1105,1352,2018-05-21,clear-day,nan
116,42,74,2018-03-22,clear-night,nan
97,94,3,2018-02-15,partly-cloudy-night,nan
392,191,201,2018-03-28,partly-cloudy-day,nan
30,21,9,2018-04-23,clear-night,nan
67,37,30,2018-02-06,clear-night,nan
489,264,225,2018-06-02,partly-cloudy-night,nan
588,321,267,2018-05-18,partly-cloudy-day,nan
2829,1091,1738,2018-04-29,partly-cloudy-day,nan
861,399,462,2018-05-06,cloudy,nan
2117,1010,1107,2018-05-08,clear-day,nan
7,4,3,2018-02-14,partly-cloudy-night,Valentine's Day
11,8,3,2018-04-08,clear-night,nan
150,76,74,2018-06-07,partly-cloudy-night,nan
219,104,115,2018-05-09,clear-day,nan
7,4,3,2018-04-05,clear-night,nan
116,65,51,2018-02-24,partly-cloudy-night,nan
1492,629,863,2018-03-15,clear-day,nan
40,20,20,2018-05-25,clear-night,nan
14,7,7,2018-04-27,clear-night,nan
509,265,244,2018-02-25,partly-cloudy-day,nan
97,47,50,2018-02-11,partly-cloudy-night,nan
20,6,14,2018-04-07,partly-cloudy-night,nan
145,60,85,2018-03-31,clear-day,nan
958,423,535,2018-03-08,rain,nan
377,237,140,2018-04-15,cloudy,nan
1786,887,899,2018-06-01,cloudy,nan
110,88,22,2018-05-12,partly-cloudy-night,nan
1384,679,705,2018-04-17,partly-cloudy-day,Tax Day
1239,562,677,2018-04-30,partly-cloudy-day,nan
86,50,36,2018-03-09,clear-night,nan
1676,967,709,2018-05-03,clear-day,nan
2924,1435,1489,2018-04-21,clear-day,nan
1326,625,701,2018-02-12,partly-cloudy-day,nan
749,416,333,2018-04-06,partly-cloudy-day,nan
12,8,4,2018-05-03,clear-night,nan
1182,543,639,2018-03-01,clear-day,nan
49,29,20,2018-04-03,partly-cloudy-night,nan
887,280,607,2018-06-09,clear-night,nan
736,386,350,2018-02-23,partly-cloudy-day,nan
449,244,205,2018-04-25,cloudy,nan
78,41,37,2018-05-31,cloudy,nan
244,115,129,2018-03-20,clear-day,nan
51,31,20,2018-03-23,clear-night,nan
1783,802,981,2018-06-05,partly-cloudy-day,nan
64,36,28,2018-04-14,clear-night,nan
1037,674,363,2018-02-18,clear-day,nan
324,139,185,2018-05-18,cloudy,nan
1753,924,829,2018-02-20,clear-day,nan
10,4,6,2018-05-10,cloudy,nan
2470,1371,1099,2018-05-26,clear-day,nan
4,2,2,2018-04-05,clear-night,nan
13,5,8,2018-05-18,clear-night,nan
41,28,13,2018-05-09,clear-night,nan
16,10,6,2018-03-03,partly-cloudy-night,nan
3491,1783,1708,2018-04-01,partly-cloudy-day,Easter Sunday
263,195,68,2018-02-13,partly-cloudy-night,nan
100,72,28,2018-03-03,partly-cloudy-night,nan
1199,544,655,2018-02-15,partly-cloudy-day,nan
21,8,13,2018-06-05,clear-night,nan
1,0,1,2018-04-16,rain,nan
6,4,2,2018-02-25,rain,nan
650,315,335,2018-03-24,clear-day,nan
430,223,207,2018-03-11,clear-night,Daylight Saving Time starts
1746,863,883,2018-04-23,clear-day,nan
2071,1021,1050,2018-04-23,clear-day,nan
1835,932,903,2018-05-04,partly-cloudy-day,nan
906,427,479,2018-02-09,partly-cloudy-day,nan
109,102,7,2018-02-14,partly-cloudy-night,Valentine's Day
17,10,7,2018-04-22,clear-night,nan
262,148,114,2018-06-06,cloudy,nan
2928,1489,1439,2018-04-28,partly-cloudy-day,nan
9,7,2,2018-02-10,partly-cloudy-night,nan
1517,801,716,2018-02-26,partly-cloudy-day,nan
125,98,27,2018-03-25,partly-cloudy-night,nan
1,0,1,2018-03-16,clear-night,nan
2493,1283,1210,2018-05-11,clear-day,nan
477,252,225,2018-04-03,partly-cloudy-day,nan
1310,618,692,2018-03-19,clear-day,nan
1609,743,866,2018-02-19,cloudy,Presidents' Day (regional holiday)
104,64,40,2018-02-28,partly-cloudy-night,nan
162,89,73,2018-05-09,clear-night,nan
6,4,2,2018-04-15,partly-cloudy-night,nan
642,170,472,2018-05-21,clear-night,nan
308,182,126,2018-04-30,partly-cloudy-day,nan
1018,538,480,2018-04-27,cloudy,nan
1143,483,660,2018-05-22,cloudy,nan
2119,993,1126,2018-03-10,cloudy,nan
1104,470,634,2018-02-08,partly-cloudy-day,nan
167,111,56,2018-04-11,partly-cloudy-night,nan
198,137,61,2018-02-19,cloudy,Presidents' Day (regional holiday)
250,135,115,2018-05-13,cloudy,Mother's Day
103,54,49,2018-03-17,clear-night,St. Patrick's Day
1032,560,472,2018-05-31,cloudy,nan
288,120,168,2018-03-26,clear-day,nan
2077,956,1121,2018-03-30,partly-cloudy-day,nan
1379,831,548,2018-05-02,clear-day,nan
129,98,31,2018-03-20,partly-cloudy-night,nan
72,36,36,2018-03-11,clear-night,Daylight Saving Time starts
8,5,3,2018-04-30,partly-cloudy-night,nan
703,390,313,2018-03-14,partly-cloudy-day,nan
10,4,6,2018-02-25,partly-cloudy-night,nan
3,1,2,2018-03-02,rain,nan
2962,1320,1642,2018-05-20,partly-cloudy-day,nan
163,99,64,2018-03-17,clear-night,St. Patrick's Day
30,14,16,2018-03-08,partly-cloudy-night,nan
1959,956,1003,2018-06-08,partly-cloudy-day,nan
1,0,1,2018-02-11,rain,nan
712,267,445,2018-04-22,clear-night,nan
1579,865,714,2018-05-01,clear-day,nan
1396,575,821,2018-03-25,partly-cloudy-day,nan
1804,883,921,2018-02-21,clear-day,nan
1151,539,612,2018-03-05,cloudy,nan
2451,1186,1265,2018-05-14,clear-day,nan
1759,844,915,2018-05-17,partly-cloudy-day,nan
797,425,372,2018-04-26,clear-day,nan
1337,736,601,2018-04-03,partly-cloudy-day,nan
457,255,202,2018-02-16,partly-cloudy-day,nan
15,6,9,2018-05-25,clear-night,nan
18,10,8,2018-06-03,rain,nan
8,5,3,2018-05-11,clear-night,nan
41,21,20,2018-06-04,rain,nan
1809,772,1037,2018-03-27,clear-day,nan
80,46,34,2018-02-07,rain,nan
1480,746,734,2018-03-03,clear-day,nan
6,4,2,2018-04-25,partly-cloudy-night,nan
539,275,264,2018-03-13,partly-cloudy-day,nan
100,48,52,2018-03-05,clear-night,nan
227,95,132,2018-05-07,clear-day,nan
41,28,13,2018-03-07,rain,nan
48,28,20,2018-02-14,partly-cloudy-night,Valentine's Day
111,47,64,2018-04-06,partly-cloudy-day,nan
539,224,315,2018-05-19,rain,nan
41,28,13,2018-02-17,clear-night,nan
238,164,74,2018-03-16,clear-night,nan
1,0,1,2018-03-13,partly-cloudy-night,nan
1778,755,1023,2018-04-24,clear-day,nan
9,2,7,2018-05-21,clear-night,nan
414,183,231,2018-04-20,clear-night,nan
133,82,51,2018-03-21,snow,nan
1984,873,1111,2018-06-11,clear-day,nan
2245,1061,1184,2018-05-21,clear-day,nan
48,31,17,2018-02-23,cloudy,nan
1635,714,921,2018-03-23,partly-cloudy-day,nan
1054,447,607,2018-02-10,partly-cloudy-day,nan
2190,1063,1127,2018-04-13,clear-day,nan
7,3,4,2018-05-17,cloudy,nan
124,55,69,2018-03-09,partly-cloudy-day,nan
908,372,536,2018-05-14,clear-day,nan
17,11,6,2018-06-09,clear-night,nan
1,0,1,2018-04-04,cloudy,nan
853,356,497,2018-05-31,cloudy,nan
1743,836,907,2018-02-21,clear-day,nan
1555,776,779,2018-04-09,partly-cloudy-day,nan
32,9,23,2018-05-05,partly-cloudy-night,Cinco de Mayo
542,338,204,2018-02-08,partly-cloudy-night,nan
41,13,28,2018-04-02,snow,nan
927,483,444,2018-02-10,partly-cloudy-day,nan
1648,775,873,2018-03-04,partly-cloudy-day,nan
2013,1134,879,2018-04-29,partly-cloudy-day,nan
1944,980,964,2018-03-18,clear-day,nan
12,6,6,2018-06-02,clear-night,nan
1669,869,800,2018-05-09,clear-day,nan
8,7,1,2018-02-22,cloudy,nan
9,3,6,2018-04-02,partly-cloudy-night,nan
3,2,1,2018-03-18,clear-night,nan
2128,1053,1075,2018-06-01,partly-cloudy-day,nan
273,116,157,2018-05-11,clear-day,nan
121,56,65,2018-05-26,clear-night,nan
1622,741,881,2018-04-05,partly-cloudy-day,nan
98,53,45,2018-02-09,clear-night,nan
1484,718,766,2018-05-03,clear-day,nan
1832,855,977,2018-05-30,partly-cloudy-day,nan
5,2,3,2018-02-15,partly-cloudy-night,nan
854,517,337,2018-04-04,partly-cloudy-day,nan
62,30,32,2018-04-27,clear-night,nan
134,96,38,2018-02-22,partly-cloudy-night,nan
1,0,1,2018-03-27,clear-night,nan
666,254,412,2018-06-01,clear-night,nan
2127,1020,1107,2018-06-08,partly-cloudy-day,nan
5,2,3,2018-02-05,clear-night,nan
1355,671,684,2018-04-12,clear-day,nan
3,0,3,2018-03-23,clear-night,nan
1007,446,561,2018-04-16,partly-cloudy-day,nan
811,394,417,2018-03-28,partly-cloudy-day,nan
11,6,5,2018-02-16,partly-cloudy-night,nan
757,381,376,2018-03-12,clear-day,nan
716,176,540,2018-05-15,clear-day,nan
1606,575,1031,2018-05-05,clear-day,Cinco de Mayo
674,328,346,2018-04-09,partly-cloudy-day,nan
5,3,2,2018-02-26,clear-night,nan
27,10,17,2018-02-27,clear-night,nan
5,3,2,2018-02-18,cloudy,nan
1,0,1,2018-02-08,partly-cloudy-night,nan
183,90,93,2018-05-29,partly-cloudy-day,nan
163,65,98,2018-05-07,partly-cloudy-night,nan
1372,719,653,2018-04-16,clear-day,nan
1344,607,737,2018-02-13,clear-day,nan
1670,946,724,2018-05-23,clear-day,nan
184,80,104,2018-06-09,clear-day,nan
63,35,28,2018-06-05,clear-night,nan
433,228,205,2018-04-28,partly-cloudy-day,nan
30,12,18,2018-04-11,clear-night,nan
12,7,5,2018-05-31,partly-cloudy-night,nan
1975,963,1012,2018-04-23,clear-day,nan
8,5,3,2018-06-08,clear-night,nan
37,16,21,2018-02-17,snow,nan
588,268,320,2018-04-14,partly-cloudy-night,nan
67,24,43,2018-03-21,snow,nan
339,212,127,2018-04-12,clear-night,nan
1051,577,474,2018-06-06,cloudy,nan
693,265,428,2018-04-29,partly-cloudy-night,nan
7,4,3,2018-02-17,clear-night,nan
1737,959,778,2018-06-10,partly-cloudy-day,nan
183,74,109,2018-03-27,clear-day,nan
659,370,289,2018-02-14,partly-cloudy-night,Valentine's Day
59,42,17,2018-02-23,cloudy,nan
109,44,65,2018-02-05,partly-cloudy-night,nan
354,166,188,2018-03-15,clear-day,nan
334,140,194,2018-02-15,partly-cloudy-day,nan
93,28,65,2018-02-07,rain,nan
195,108,87,2018-02-20,clear-night,nan
134,97,37,2018-02-09,clear-night,nan
417,182,235,2018-02-26,clear-day,nan
145,54,91,2018-03-16,clear-night,nan
177,62,115,2018-02-23,cloudy,nan
302,113,189,2018-06-06,partly-cloudy-day,nan
425,166,259,2018-05-07,partly-cloudy-night,nan
123,57,66,2018-03-05,partly-cloudy-day,nan
18,13,5,2018-05-19,cloudy,nan
69,33,36,2018-02-16,partly-cloudy-day,nan
4,2,2,2018-02-27,clear-night,nan
166,99,67,2018-04-16,rain,nan
246,105,141,2018-05-23,partly-cloudy-day,nan
83,42,41,2018-04-05,clear-night,nan
1643,733,910,2018-03-04,partly-cloudy-day,nan
398,265,133,2018-02-27,clear-night,nan
5,4,1,2018-03-10,partly-cloudy-night,nan
270,118,152,2018-05-26,clear-day,nan
1578,711,867,2018-03-15,clear-day,nan
962,486,476,2018-02-08,clear-day,nan
3420,1828,1592,2018-03-31,clear-day,nan
716,374,342,2018-02-13,clear-day,nan
22,10,12,2018-03-27,clear-night,nan
2409,1075,1334,2018-05-14,cloudy,nan
19,11,8,2018-05-06,cloudy,nan
11,4,7,2018-03-25,partly-cloudy-night,nan
459,193,266,2018-03-08,partly-cloudy-night,nan
279,156,123,2018-05-04,clear-day,nan
423,199,224,2018-03-10,cloudy,nan
1777,669,1108,2018-04-01,clear-day,Easter Sunday
138,66,72,2018-02-20,clear-night,nan
609,220,389,2018-05-01,clear-day,nan
101,45,56,2018-04-07,cloudy,nan
173,97,76,2018-04-25,fog,nan
32,14,18,2018-04-17,partly-cloudy-night,Tax Day
200,88,112,2018-05-03,clear-day,nan
294,120,174,2018-04-20,clear-day,nan
19,14,5,2018-05-30,clear-night,nan
8,4,4,2018-02-14,partly-cloudy-night,Valentine's Day
178,59,119,2018-02-20,fog,nan
2686,505,2181,2018-03-31,clear-day,nan
196,90,106,2018-02-27,clear-day,nan
18,11,7,2018-05-09,clear-night,nan
2446,1226,1220,2018-05-11,clear-day,nan
8,0,8,2018-05-12,rain,nan
262,109,153,2018-06-12,clear-day,nan
31,21,10,2018-05-26,clear-night,nan
103,36,67,2018-02-09,clear-night,nan
1025,425,600,2018-05-02,partly-cloudy-night,nan
130,62,68,2018-03-21,snow,nan
527,249,278,2018-04-18,partly-cloudy-day,nan
13,6,7,2018-05-20,cloudy,nan
169,77,92,2018-05-25,clear-day,nan
124,55,69,2018-06-01,cloudy,nan
1060,336,724,2018-05-26,clear-night,nan
802,419,383,2018-04-19,partly-cloudy-day,nan
12,8,4,2018-06-06,partly-cloudy-night,nan
321,185,136,2018-03-06,partly-cloudy-night,nan
311,139,172,2018-04-23,clear-night,nan
232,102,130,2018-05-15,fog,nan
289,114,175,2018-05-01,clear-night,nan
1071,516,555,2018-05-31,cloudy,nan
656,442,214,2018-04-29,partly-cloudy-day,nan
19,13,6,2018-04-14,clear-night,nan
717,370,347,2018-03-20,partly-cloudy-day,nan
1,0,1,2018-04-18,partly-cloudy-night,nan
93,51,42,2018-03-10,clear-day,nan
2270,1009,1261,2018-06-11,clear-day,nan
2,0,2,2018-03-21,cloudy,nan
1548,737,811,2018-03-25,partly-cloudy-day,nan
8,5,3,2018-03-30,partly-cloudy-night,nan
1836,944,892,2018-05-17,partly-cloudy-day,nan
416,253,163,2018-05-27,rain,nan
468,221,247,2018-05-23,clear-night,nan
85,36,49,2018-02-18,clear-night,nan
2464,1147,1317,2018-05-28,cloudy,Memorial Day
659,384,275,2018-05-10,partly-cloudy-day,nan
848,458,390,2018-05-16,partly-cloudy-day,nan
86,62,24,2018-04-03,cloudy,nan
7,4,3,2018-04-25,cloudy,nan
290,157,133,2018-04-17,partly-cloudy-night,Tax Day
67,53,14,2018-03-14,partly-cloudy-night,nan
75,45,30,2018-03-16,clear-night,nan
11,8,3,2018-03-28,cloudy,nan
136,62,74,2018-03-14,clear-night,nan
0,0,0,2018-03-08,partly-cloudy-night,nan
1008,582,426,2018-03-22,rain,nan
1424,833,591,2018-05-24,clear-day,nan
15,6,9,2018-05-17,cloudy,nan
396,152,244,2018-05-29,clear-night,nan
1270,659,611,2018-03-11,clear-day,Daylight Saving Time starts
26,16,10,2018-04-02,clear-night,nan
477,278,199,2018-05-22,rain,nan
428,196,232,2018-06-01,clear-night,nan
1727,982,745,2018-05-09,clear-day,nan
1365,654,711,2018-03-19,clear-day,nan
1007,501,506,2018-03-09,partly-cloudy-day,nan
653,297,356,2018-03-20,clear-day,nan
1236,627,609,2018-03-16,partly-cloudy-day,nan
295,106,189,2018-05-21,clear-night,nan
272,96,176,2018-04-09,clear-day,nan
65,37,28,2018-05-24,clear-night,nan
823,450,373,2018-04-02,snow,nan
180,79,101,2018-04-11,partly-cloudy-night,nan
87,59,28,2018-05-10,rain,nan
284,75,209,2018-03-29,partly-cloudy-day,nan
1876,821,1055,2018-02-17,cloudy,nan
210,158,52,2018-02-15,partly-cloudy-night,nan
360,209,151,2018-03-23,partly-cloudy-night,nan
11,6,5,2018-03-12,partly-cloudy-night,nan
1559,717,842,2018-02-19,cloudy,Presidents' Day (regional holiday)
1264,666,598,2018-04-11,clear-day,nan
43,11,32,2018-03-25,partly-cloudy-night,nan
20,11,9,2018-02-06,clear-night,nan
18,12,6,2018-04-15,rain,nan
364,141,223,2018-05-04,clear-night,nan
903,426,477,2018-02-06,partly-cloudy-day,nan
1140,603,537,2018-03-27,partly-cloudy-day,nan
13,11,2,2018-03-01,rain,nan
2854,1574,1280,2018-05-05,clear-day,Cinco de Mayo
301,172,129,2018-02-11,partly-cloudy-day,nan
75,24,51,2018-06-10,partly-cloudy-night,nan
1947,822,1125,2018-04-08,partly-cloudy-day,nan
53,26,27,2018-04-19,cloudy,nan
25,17,8,2018-03-11,partly-cloudy-night,Daylight Saving Time starts
644,348,296,2018-02-28,clear-day,nan
1021,439,582,2018-04-15,cloudy,nan
456,200,256,2018-02-21,cloudy,nan
70,40,30,2018-04-08,clear-night,nan
1037,582,455,2018-02-17,clear-day,nan
31,25,6,2018-02-07,partly-cloudy-night,nan
1709,950,759,2018-06-08,partly-cloudy-day,nan
187,99,88,2018-02-22,rain,nan
2,0,2,2018-02-13,clear-night,nan
33,19,14,2018-02-22,cloudy,nan
49,24,25,2018-03-05,clear-night,nan
75,36,39,2018-03-03,partly-cloudy-day,nan
966,554,412,2018-06-07,cloudy,nan
2032,928,1104,2018-05-24,clear-day,nan
151,124,27,2018-02-22,partly-cloudy-night,nan
31,15,16,2018-04-22,clear-night,nan
1097,556,541,2018-02-16,clear-day,nan
112,69,43,2018-03-09,clear-night,nan
44,22,22,2018-02-05,clear-night,nan
1966,958,1008,2018-04-13,clear-day,nan
3390,1490,1900,2018-05-05,clear-day,Cinco de Mayo
6,2,4,2018-04-03,clear-night,nan
205,151,54,2018-02-10,partly-cloudy-night,nan
664,288,376,2018-04-30,partly-cloudy-day,nan
50,32,18,2018-02-11,cloudy,nan
2084,1239,845,2018-06-09,clear-day,nan
139,118,21,2018-03-11,clear-night,Daylight Saving Time starts
673,289,384,2018-05-04,partly-cloudy-night,nan
1658,929,729,2018-06-05,partly-cloudy-day,nan
518,220,298,2018-05-16,rain,nan
203,99,104,2018-03-07,partly-cloudy-day,nan
991,534,457,2018-05-21,clear-day,nan
202,100,102,2018-05-15,clear-night,nan
426,254,172,2018-02-06,partly-cloudy-day,nan
1865,844,1021,2018-03-28,partly-cloudy-day,nan
34,14,20,2018-04-30,partly-cloudy-night,nan
1805,772,1033,2018-04-24,partly-cloudy-day,nan
11,5,6,2018-04-11,clear-night,nan
288,96,192,2018-06-08,clear-day,nan
159,136,23,2018-02-08,clear-night,nan
312,148,164,2018-04-05,clear-day,nan
6,4,2,2018-03-15,partly-cloudy-night,nan
2127,1012,1115,2018-02-24,partly-cloudy-day,nan
344,131,213,2018-05-17,clear-night,nan
2290,1075,1215,2018-05-18,cloudy,nan
1613,817,796,2018-04-26,clear-day,nan
1032,490,542,2018-02-14,partly-cloudy-day,Valentine's Day
188,69,119,2018-03-12,clear-day,nan
139,57,82,2018-05-30,partly-cloudy-night,nan
1092,525,567,2018-02-28,clear-day,nan
2,1,1,2018-02-25,rain,nan
1817,1078,739,2018-06-04,partly-cloudy-day,nan
13,4,9,2018-03-20,clear-night,nan
1110,546,564,2018-02-15,partly-cloudy-day,nan
2887,1271,1616,2018-04-22,clear-day,nan
765,359,406,2018-04-12,clear-day,nan
55,27,28,2018-02-13,clear-night,nan
5,3,2,2018-02-20,fog,nan
69,30,39,2018-04-02,clear-night,nan
2282,1047,1235,2018-05-25,clear-day,nan
95,92,3,2018-02-07,rain,nan
34,18,16,2018-05-27,rain,nan
0,0,0,2018-04-26,rain,nan
0,0,0,2018-03-03,partly-cloudy-night,nan
593,387,206,2018-05-17,partly-cloudy-day,nan
29,16,13,2018-05-19,cloudy,nan
21,14,7,2018-04-28,partly-cloudy-night,nan
122,63,59,2018-05-22,cloudy,nan
796,436,360,2018-03-13,partly-cloudy-day,nan
1328,617,711,2018-03-12,clear-day,nan
218,80,138,2018-05-27,clear-night,nan
286,144,142,2018-04-10,partly-cloudy-night,nan
15,10,5,2018-05-13,cloudy,Mother's Day
1810,801,1009,2018-06-02,partly-cloudy-day,nan
2,0,2,2018-02-23,partly-cloudy-night,nan
2722,1005,1717,2018-06-02,clear-day,nan
2,1,1,2018-02-09,clear-night,nan
969,373,596,2018-02-18,clear-night,nan
1,0,1,2018-03-26,clear-night,nan
1799,975,824,2018-06-04,partly-cloudy-day,nan
227,87,140,2018-04-27,partly-cloudy-day,nan
1529,732,797,2018-04-24,clear-day,nan
25,10,15,2018-03-31,clear-night,nan
840,339,501,2018-03-04,partly-cloudy-night,nan
16,6,10,2018-04-16,rain,nan
1533,668,865,2018-04-06,partly-cloudy-day,nan
65,43,22,2018-05-02,clear-night,nan
1005,369,636,2018-04-21,clear-night,nan
2276,1226,1050,2018-04-13,clear-day,nan
276,90,186,2018-03-01,clear-day,nan
2225,1064,1161,2018-05-07,partly-cloudy-day,nan
2061,1157,904,2018-05-24,clear-day,nan
401,255,146,2018-02-26,clear-night,nan
2232,1136,1096,2018-03-11,clear-day,Daylight Saving Time starts
1,0,1,2018-03-14,clear-night,nan
697,330,367,2018-05-06,partly-cloudy-night,nan
163,85,78,2018-03-25,partly-cloudy-day,nan
37,27,10,2018-02-24,partly-cloudy-night,nan
2910,1396,1514,2018-04-22,clear-day,nan
2156,866,1290,2018-04-20,clear-day,nan
234,118,116,2018-05-06,partly-cloudy-night,nan
773,431,342,2018-02-25,partly-cloudy-day,nan
1559,743,816,2018-03-27,clear-day,nan
31,21,10,2018-04-15,cloudy,nan
5,1,4,2018-03-22,snow,nan
261,109,152,2018-03-19,clear-night,nan
98,69,29,2018-05-13,nan,Mother's Day
197,81,116,2018-05-08,clear-day,nan
1031,495,536,2018-03-08,rain,nan
38,23,15,2018-06-11,partly-cloudy-night,nan
4,0,4,2018-06-12,clear-night,nan
989,468,521,2018-05-13,partly-cloudy-day,Mother's Day
1301,639,662,2018-03-05,partly-cloudy-day,nan
405,156,249,2018-03-26,clear-night,nan
12,5,7,2018-05-08,clear-night,nan
1546,843,703,2018-04-04,partly-cloudy-day,nan
3,0,3,2018-05-22,clear-night,nan
1114,563,551,2018-05-13,partly-cloudy-day,Mother's Day
761,389,372,2018-05-12,cloudy,nan
7,0,7,2018-02-28,clear-night,nan
20,12,8,2018-03-24,partly-cloudy-night,nan
232,85,147,2018-05-19,cloudy,nan
1190,710,480,2018-03-30,partly-cloudy-day,nan
168,78,90,2018-05-30,cloudy,nan
30,18,12,2018-04-14,clear-night,nan
4,0,4,2018-04-04,cloudy,nan
528,179,349,2018-05-08,clear-night,nan
34,10,24,2018-05-04,partly-cloudy-night,nan
483,215,268,2018-03-30,partly-cloudy-night,nan
1527,726,801,2018-03-06,clear-day,nan
9,7,2,2018-02-24,partly-cloudy-night,nan
1182,611,571,2018-06-11,clear-day,nan
1781,823,958,2018-04-18,partly-cloudy-day,nan
376,197,179,2018-04-25,fog,nan
5,0,5,2018-03-12,clear-night,nan
2215,1132,1083,2018-02-18,rain,nan
1501,664,837,2018-04-11,partly-cloudy-day,nan
2300,1028,1272,2018-03-17,clear-day,St. Patrick's Day
621,260,361,2018-05-31,partly-cloudy-day,nan
13,6,7,2018-03-19,clear-night,nan
2888,1426,1462,2018-05-26,clear-day,nan
71,35,36,2018-02-16,clear-night,nan
341,170,171,2018-02-14,partly-cloudy-day,Valentine's Day
0,0,0,2018-03-23,clear-night,nan
1289,673,616,2018-04-04,cloudy,nan
1674,791,883,2018-04-02,partly-cloudy-day,nan
1783,866,917,2018-05-09,clear-day,nan
25,13,12,2018-04-02,snow,nan
2501,1245,1256,2018-04-26,clear-day,nan
1584,830,754,2018-02-26,clear-day,nan
516,221,295,2018-04-12,partly-cloudy-day,nan
6,1,5,2018-03-07,partly-cloudy-night,nan
767,373,394,2018-05-11,partly-cloudy-night,nan
11,8,3,2018-03-01,partly-cloudy-night,nan
4,2,2,2018-03-06,clear-night,nan
601,377,224,2018-03-22,partly-cloudy-day,nan
7,2,5,2018-05-20,fog,nan
1247,639,608,2018-03-28,partly-cloudy-day,nan
43,23,20,2018-04-10,partly-cloudy-night,nan
3638,1484,2154,2018-04-28,clear-day,nan
315,153,162,2018-03-13,partly-cloudy-day,nan
342,168,174,2018-05-05,partly-cloudy-night,Cinco de Mayo
817,447,370,2018-06-03,partly-cloudy-day,nan
2625,1209,1416,2018-03-24,clear-day,nan
8,6,2,2018-05-04,clear-night,nan
956,396,560,2018-04-19,partly-cloudy-day,nan
1559,595,964,2018-05-20,partly-cloudy-day,nan
1713,803,910,2018-05-03,clear-day,nan
150,117,33,2018-03-29,cloudy,nan
3,1,2,2018-04-23,clear-night,nan
139,92,47,2018-04-19,clear-night,nan
1188,687,501,2018-03-29,partly-cloudy-day,nan
1399,756,643,2018-06-07,clear-day,nan
3062,1495,1567,2018-06-09,clear-day,nan
23,20,3,2018-02-18,clear-night,nan
13,7,6,2018-05-15,partly-cloudy-night,nan
7,6,1,2018-03-04,partly-cloudy-night,nan
1492,689,803,2018-03-16,partly-cloudy-day,nan
1548,836,712,2018-06-01,clear-day,nan
51,16,35,2018-04-09,partly-cloudy-night,nan
935,437,498,2018-04-20,clear-day,nan
648,378,270,2018-03-19,clear-day,nan
629,396,233,2018-04-27,partly-cloudy-day,nan
354,159,195,2018-05-27,cloudy,nan
11,8,3,2018-04-21,clear-night,nan
232,114,118,2018-02-11,rain,nan
39,26,13,2018-03-02,rain,nan
1578,785,793,2018-06-05,cloudy,nan
1232,733,499,2018-06-03,partly-cloudy-day,nan
850,480,370,2018-04-01,partly-cloudy-day,Easter Sunday
334,118,216,2018-05-14,partly-cloudy-day,nan
234,87,147,2018-04-03,partly-cloudy-day,nan
400,151,249,2018-06-08,partly-cloudy-night,nan
850,474,376,2018-03-23,partly-cloudy-day,nan
1354,828,526,2018-05-23,rain,nan
30,11,19,2018-03-21,fog,nan
209,80,129,2018-03-23,clear-day,nan
300,89,211,2018-05-28,cloudy,Memorial Day
1,1,0,2018-04-28,partly-cloudy-night,nan
4,2,2,2018-03-28,partly-cloudy-night,nan
653,342,311,2018-04-23,clear-day,nan
29,14,15,2018-03-07,partly-cloudy-night,nan
233,101,132,2018-03-17,clear-night,St. Patrick's Day
407,240,167,2018-02-21,partly-cloudy-night,nan
38,26,12,2018-05-28,cloudy,Memorial Day
1609,833,776,2018-04-08,clear-day,nan
671,313,358,2018-02-05,clear-day,nan
6,2,4,2018-04-12,partly-cloudy-night,nan
125,71,54,2018-05-28,partly-cloudy-day,Memorial Day
1742,1041,701,2018-04-05,clear-day,nan
1175,629,546,2018-03-22,clear-day,nan
80,40,40,2018-02-12,clear-night,nan
2978,1281,1697,2018-05-20,partly-cloudy-day,nan
604,258,346,2018-04-15,cloudy,nan
18,11,7,2018-04-10,partly-cloudy-night,nan
56,14,42,2018-03-18,clear-night,nan
18,11,7,2018-02-21,cloudy,nan
232,93,139,2018-04-24,clear-day,nan
1780,829,951,2018-05-29,clear-day,nan
2459,1166,1293,2018-05-25,clear-day,nan
51,26,25,2018-02-07,clear-night,nan
1831,1021,810,2018-03-24,clear-day,nan
1892,798,1094,2018-05-29,clear-day,nan
1452,653,799,2018-04-17,partly-cloudy-day,Tax Day
70,48,22,2018-02-19,partly-cloudy-night,Presidents' Day (regional holiday)
1,0,1,2018-06-04,rain,nan
2247,1249,998,2018-05-21,clear-day,nan
10,8,2,2018-02-12,partly-cloudy-night,nan
548,344,204,2018-03-01,partly-cloudy-night,nan
109,105,4,2018-02-10,rain,nan
10,3,7,2018-03-13,sleet,nan
58,28,30,2018-03-02,rain,nan
1,0,1,2018-04-19,partly-cloudy-night,nan
1414,643,771,2018-03-09,partly-cloudy-day,nan
283,113,170,2018-05-25,clear-night,nan
663,249,414,2018-02-22,partly-cloudy-day,nan
1835,842,993,2018-03-23,partly-cloudy-day,nan
1575,675,900,2018-05-10,partly-cloudy-day,nan
141,63,78,2018-02-25,cloudy,nan
50,25,25,2018-06-10,partly-cloudy-night,nan
34,23,11,2018-03-18,clear-night,nan
1027,491,536,2018-06-10,partly-cloudy-day,nan
885,465,420,2018-03-12,partly-cloudy-day,nan
58,25,33,2018-04-04,fog,nan
1036,483,553,2018-02-09,partly-cloudy-day,nan
2021,854,1167,2018-02-18,clear-day,nan
288,98,190,2018-04-11,clear-day,nan
794,408,386,2018-02-24,partly-cloudy-day,nan
1131,562,569,2018-02-15,clear-day,nan
2328,1006,1322,2018-05-18,clear-day,nan
34,18,16,2018-04-08,cloudy,nan
1927,891,1036,2018-06-01,partly-cloudy-day,nan
0,0,0,2018-04-16,rain,nan
89,40,49,2018-03-13,clear-night,nan
1508,888,620,2018-04-01,clear-day,Easter Sunday
582,310,272,2018-03-25,partly-cloudy-day,nan
324,148,176,2018-06-04,partly-cloudy-night,nan
157,74,83,2018-03-19,clear-night,nan
0,0,0,2018-03-22,partly-cloudy-night,nan
384,168,216,2018-04-30,partly-cloudy-day,nan
113,72,41,2018-02-25,rain,nan
1374,651,723,2018-04-02,rain,nan
3,1,2,2018-02-10,partly-cloudy-night,nan
260,151,109,2018-04-27,partly-cloudy-night,nan
213,120,93,2018-04-26,clear-night,nan
688,366,322,2018-02-14,partly-cloudy-day,Valentine's Day
9,0,9,2018-04-15,cloudy,nan
91,44,47,2018-06-10,partly-cloudy-night,nan
161,97,64,2018-05-12,rain,nan
2,1,1,2018-02-19,clear-night,Presidents' Day (regional holiday)
240,107,133,2018-03-30,partly-cloudy-night,nan
162,121,41,2018-03-15,partly-cloudy-night,nan
55,33,22,2018-02-08,clear-night,nan
1,0,1,2018-02-28,clear-night,nan
799,430,369,2018-03-08,partly-cloudy-day,nan
549,340,209,2018-05-22,partly-cloudy-day,nan
293,162,131,2018-06-02,partly-cloudy-night,nan
153,79,74,2018-03-26,clear-day,nan
1775,776,999,2018-04-18,partly-cloudy-day,nan
0,0,0,2018-02-13,clear-night,nan
179,102,77,2018-04-06,partly-cloudy-night,nan
888,478,410,2018-02-27,clear-day,nan
46,22,24,2018-03-04,clear-night,nan
1613,793,820,2018-06-04,cloudy,nan
1335,571,764,2018-03-14,partly-cloudy-day,nan
1287,576,711,2018-03-05,cloudy,nan
275,156,119,2018-05-16,cloudy,nan
37,17,20,2018-03-21,snow,nan
84,65,19,2018-02-24,partly-cloudy-night,nan
668,373,295,2018-04-05,clear-day,nan
470,304,166,2018-05-12,partly-cloudy-day,nan
1607,768,839,2018-06-10,partly-cloudy-day,nan
360,127,233,2018-05-18,partly-cloudy-day,nan
1890,1006,884,2018-05-02,partly-cloudy-day,nan
403,178,225,2018-03-03,cloudy,nan
88,67,21,2018-04-04,clear-night,nan
2442,1032,1410,2018-05-01,clear-day,nan
2150,948,1202,2018-05-07,partly-cloudy-day,nan
773,378,395,2018-05-09,clear-day,nan
74,20,54,2018-02-26,clear-night,nan
1481,509,972,2018-04-22,clear-day,nan
1981,990,991,2018-03-03,clear-day,nan
11,8,3,2018-04-12,clear-night,nan
144,64,80,2018-04-16,partly-cloudy-night,nan
314,170,144,2018-02-25,rain,nan
400,145,255,2018-05-24,clear-night,nan
632,344,288,2018-06-11,partly-cloudy-day,nan
1996,1046,950,2018-04-26,clear-day,nan
2302,1330,972,2018-04-21,clear-day,nan
2327,1046,1281,2018-04-20,clear-day,nan
1889,874,1015,2018-05-06,cloudy,nan
1999,826,1173,2018-03-27,clear-day,nan
82,63,19,2018-05-13,rain,Mother's Day
544,246,298,2018-05-03,partly-cloudy-night,nan
48,19,29,2018-04-30,partly-cloudy-night,nan
141,37,104,2018-04-06,partly-cloudy-day,nan
425,154,271,2018-05-22,partly-cloudy-day,nan
313,163,150,2018-03-19,clear-day,nan
289,95,194,2018-03-27,clear-day,nan
971,471,500,2018-03-01,clear-day,nan
304,138,166,2018-05-02,partly-cloudy-night,nan
24,12,12,2018-05-27,clear-night,nan
1236,646,590,2018-04-24,partly-cloudy-day,nan
3263,1581,1682,2018-04-14,clear-day,nan
29,15,14,2018-04-13,clear-night,nan
15,10,5,2018-06-09,clear-night,nan
43,25,18,2018-05-19,cloudy,nan
2023,1137,886,2018-05-26,clear-day,nan
261,101,160,2018-03-05,clear-day,nan
194,64,130,2018-03-20,clear-day,nan
1364,563,801,2018-03-17,clear-day,St. Patrick's Day
2064,964,1100,2018-05-12,partly-cloudy-day,nan
4,1,3,2018-03-25,clear-night,nan
269,188,81,2018-02-27,clear-night,nan
1898,952,946,2018-04-18,clear-day,nan
214,167,47,2018-02-13,partly-cloudy-night,nan
1240,527,713,2018-03-06,clear-day,nan
163,88,75,2018-05-31,cloudy,nan
3,0,3,2018-02-09,clear-night,nan
5,2,3,2018-04-05,partly-cloudy-night,nan
11,4,7,2018-03-02,partly-cloudy-night,nan
68,26,42,2018-03-11,clear-night,Daylight Saving Time starts
28,17,11,2018-04-22,clear-night,nan
1963,1103,860,2018-06-08,partly-cloudy-day,nan
15,8,7,2018-04-01,partly-cloudy-night,Easter Sunday
172,81,91,2018-05-11,clear-day,nan
1012,621,391,2018-05-20,partly-cloudy-day,nan
787,448,339,2018-02-21,partly-cloudy-day,nan
1357,678,679,2018-03-23,clear-day,nan
36,26,10,2018-03-04,cloudy,nan
8,6,2,2018-04-20,clear-night,nan
1709,788,921,2018-03-29,cloudy,nan
1905,865,1040,2018-03-18,clear-day,nan
16,14,2,2018-05-18,clear-night,nan
46,25,21,2018-06-07,cloudy,nan
1967,921,1046,2018-05-04,clear-day,nan
24,14,10,2018-04-12,partly-cloudy-night,nan
228,126,102,2018-03-22,clear-night,nan
8,6,2,2018-03-18,clear-night,nan
105,64,41,2018-03-06,clear-night,nan
1342,585,757,2018-02-26,partly-cloudy-day,nan
239,192,47,2018-03-24,partly-cloudy-night,nan
2507,1184,1323,2018-04-07,partly-cloudy-day,nan
9,7,2,2018-03-29,cloudy,nan
83,26,57,2018-05-21,clear-night,nan
2531,1293,1238,2018-05-21,clear-day,nan
5,3,2,2018-03-31,partly-cloudy-night,nan
1777,870,907,2018-05-27,cloudy,nan
1110,573,537,2018-04-06,partly-cloudy-day,nan
10,6,4,2018-03-07,snow,nan
51,24,27,2018-05-12,partly-cloudy-night,nan
520,263,257,2018-04-09,partly-cloudy-day,nan
6,2,4,2018-04-10,partly-cloudy-night,nan
25,20,5,2018-06-03,partly-cloudy-night,nan
1886,891,995,2018-04-06,clear-day,nan
466,205,261,2018-04-03,rain,nan
1108,574,534,2018-05-19,cloudy,nan
2060,908,1152,2018-06-03,partly-cloudy-day,nan
242,97,145,2018-05-24,clear-day,nan
494,271,223,2018-03-29,fog,nan
2405,934,1471,2018-05-05,partly-cloudy-day,Cinco de Mayo
591,229,362,2018-06-05,partly-cloudy-night,nan
1714,772,942,2018-05-15,clear-day,nan
321,173,148,2018-04-22,clear-day,nan
301,118,183,2018-03-28,partly-cloudy-day,nan
2,0,2,2018-03-24,partly-cloudy-night,nan
96,44,52,2018-03-04,cloudy,nan
1010,456,554,2018-04-15,wind,nan
198,100,98,2018-04-28,partly-cloudy-day,nan
1084,594,490,2018-04-10,partly-cloudy-day,nan
727,251,476,2018-06-03,partly-cloudy-day,nan
1751,900,851,2018-05-09,clear-day,nan
1,0,1,2018-05-14,partly-cloudy-night,nan
2029,1034,995,2018-03-26,clear-day,nan
2290,990,1300,2018-04-26,clear-day,nan
1974,913,1061,2018-05-23,partly-cloudy-day,nan
1841,860,981,2018-05-18,cloudy,nan
7,4,3,2018-03-21,partly-cloudy-night,nan
216,109,107,2018-03-20,partly-cloudy-day,nan
7,6,1,2018-02-24,partly-cloudy-night,nan
27,17,10,2018-03-18,clear-night,nan
79,41,38,2018-02-12,partly-cloudy-night,nan
30,10,20,2018-03-15,partly-cloudy-night,nan
1942,1088,854,2018-05-20,partly-cloudy-day,nan
2982,1237,1745,2018-04-29,partly-cloudy-day,nan
15,4,11,2018-05-20,fog,nan
0,0,0,2018-03-07,partly-cloudy-night,nan
70,30,40,2018-05-22,cloudy,nan
168,154,14,2018-04-21,clear-night,nan
890,428,462,2018-02-05,clear-day,nan
12,8,4,2018-04-27,clear-night,nan
919,479,440,2018-02-10,partly-cloudy-day,nan
3350,1313,2037,2018-04-28,clear-day,nan
895,339,556,2018-03-18,clear-day,nan
27,16,11,2018-04-23,clear-night,nan
76,29,47,2018-06-02,clear-day,nan
11,4,7,2018-04-24,clear-night,nan
782,368,414,2018-02-28,clear-night,nan
2874,1231,1643,2018-04-05,partly-cloudy-day,nan
76,40,36,2018-06-04,rain,nan
192,76,116,2018-05-31,partly-cloudy-day,nan
2307,966,1341,2018-05-01,clear-day,nan
1282,799,483,2018-05-19,rain,nan
1558,731,827,2018-04-12,clear-day,nan
1735,978,757,2018-05-28,partly-cloudy-day,Memorial Day
72,37,35,2018-03-28,partly-cloudy-night,nan
1480,650,830,2018-04-17,partly-cloudy-day,Tax Day
979,518,461,2018-04-17,partly-cloudy-day,Tax Day
3325,1783,1542,2018-04-28,partly-cloudy-day,nan
443,310,133,2018-02-06,clear-night,nan
1222,571,651,2018-03-09,partly-cloudy-day,nan
75,26,49,2018-06-10,partly-cloudy-day,nan
1674,882,792,2018-05-10,clear-day,nan
39,28,11,2018-05-05,clear-night,Cinco de Mayo
1425,698,727,2018-02-20,cloudy,nan
418,152,266,2018-05-30,partly-cloudy-night,nan
14,7,7,2018-02-26,partly-cloudy-night,nan
16,11,5,2018-03-02,rain,nan
188,81,107,2018-04-19,partly-cloudy-day,nan
4,3,1,2018-04-04,cloudy,nan
873,259,614,2018-04-13,clear-night,nan
1721,875,846,2018-05-14,clear-day,nan
1451,710,741,2018-04-09,clear-day,nan
581,309,272,2018-02-10,rain,nan
3180,1492,1688,2018-04-01,partly-cloudy-day,Easter Sunday
1722,913,809,2018-05-25,clear-day,nan
1777,804,973,2018-05-30,partly-cloudy-day,nan
1082,448,634,2018-04-05,partly-cloudy-day,nan
2,1,1,2018-02-08,partly-cloudy-night,nan
1249,810,439,2018-04-23,clear-day,nan
549,299,250,2018-02-10,partly-cloudy-day,nan
246,130,116,2018-02-19,clear-day,Presidents' Day (regional holiday)
167,126,41,2018-02-14,partly-cloudy-night,Valentine's Day
21,13,8,2018-04-29,cloudy,nan
22,10,12,2018-06-01,cloudy,nan
278,195,83,2018-03-31,clear-night,nan
590,365,225,2018-02-09,partly-cloudy-day,nan
17,11,6,2018-02-15,partly-cloudy-night,nan
136,65,71,2018-06-06,cloudy,nan
5,3,2,2018-03-27,clear-night,nan
38,28,10,2018-03-10,partly-cloudy-night,nan
1,0,1,2018-02-05,clear-night,nan
853,316,537,2018-05-07,partly-cloudy-night,nan
3278,1532,1746,2018-04-21,clear-day,nan
42,26,16,2018-03-22,partly-cloudy-night,nan
2,0,2,2018-03-16,clear-night,nan
1343,687,656,2018-03-28,partly-cloudy-day,nan
4,3,1,2018-02-16,partly-cloudy-night,nan
3657,1640,2017,2018-05-28,cloudy,Memorial Day
12,6,6,2018-05-22,clear-night,nan
11,5,6,2018-05-31,partly-cloudy-night,nan
1022,503,519,2018-03-03,clear-day,nan
3,1,2,2018-04-20,partly-cloudy-night,nan
15,10,5,2018-02-20,fog,nan
29,16,13,2018-05-08,clear-night,nan
2183,979,1204,2018-03-10,partly-cloudy-day,nan
1184,530,654,2018-02-13,clear-day,nan
5,3,2,2018-05-01,partly-cloudy-night,nan
19,13,6,2018-02-26,clear-night,nan
4,3,1,2018-02-18,snow,nan
1244,694,550,2018-04-16,clear-day,nan
6,3,3,2018-06-05,clear-night,nan
740,358,382,2018-03-15,clear-day,nan
1498,650,848,2018-02-27,clear-day,nan
5,4,1,2018-04-11,clear-night,nan
888,505,383,2018-03-04,cloudy,nan
2035,1178,857,2018-05-01,clear-day,nan
76,46,30,2018-03-08,partly-cloudy-night,nan
444,248,196,2018-04-17,partly-cloudy-day,Tax Day
59,26,33,2018-04-22,clear-night,nan
29,12,17,2018-03-20,partly-cloudy-night,nan
1861,888,973,2018-05-02,clear-day,nan
1871,791,1080,2018-05-30,partly-cloudy-day,nan
917,379,538,2018-03-25,clear-day,nan
1900,928,972,2018-06-08,clear-day,nan
2747,1391,1356,2018-03-30,partly-cloudy-day,nan
1807,848,959,2018-02-21,clear-day,nan
1,0,1,2018-03-20,clear-night,nan
2388,1273,1115,2018-05-14,clear-day,nan
14,5,9,2018-04-07,cloudy,nan
177,70,107,2018-02-28,clear-day,nan
183,105,78,2018-03-21,snow,nan
2,1,1,2018-05-16,partly-cloudy-night,nan
1969,882,1087,2018-03-26,clear-day,nan
0,0,0,2018-03-05,partly-cloudy-night,nan
1571,639,932,2018-06-06,partly-cloudy-day,nan
2156,1054,1102,2018-05-17,clear-day,nan
454,235,219,2018-05-16,partly-cloudy-day,nan
1209,753,456,2018-06-01,partly-cloudy-day,nan
123,74,49,2018-04-15,cloudy,nan
19,9,10,2018-05-03,clear-night,nan
4,2,2,2018-04-09,clear-night,nan
2087,891,1196,2018-05-08,clear-day,nan
637,264,373,2018-03-19,clear-day,nan
13,10,3,2018-04-25,partly-cloudy-night,nan
1857,744,1113,2018-03-25,partly-cloudy-day,nan
145,81,64,2018-05-26,clear-day,nan
144,67,77,2018-05-07,clear-day,nan
596,300,296,2018-04-13,clear-day,nan
1606,640,966,2018-06-09,partly-cloudy-day,nan
3,0,3,2018-02-27,clear-night,nan
17,14,3,2018-05-25,clear-night,nan
912,429,483,2018-03-16,partly-cloudy-day,nan
375,185,190,2018-05-26,clear-night,nan
1231,601,630,2018-03-26,clear-day,nan
60,22,38,2018-03-09,partly-cloudy-night,nan
5,3,2,2018-03-10,clear-night,nan
764,413,351,2018-03-01,clear-day,nan
1693,844,849,2018-05-13,cloudy,Mother's Day
10,8,2,2018-04-29,cloudy,nan
16,6,10,2018-05-17,cloudy,nan
1874,1062,812,2018-05-21,clear-day,nan
1684,825,859,2018-03-04,partly-cloudy-day,nan
18,13,5,2018-03-06,partly-cloudy-night,nan
11,5,6,2018-03-14,clear-night,nan
19,11,8,2018-04-18,cloudy,nan
1553,695,858,2018-03-15,clear-day,nan
218,103,115,2018-06-06,partly-cloudy-day,nan
1536,787,749,2018-05-04,partly-cloudy-day,nan
4,1,3,2018-05-09,clear-night,nan
852,544,308,2018-05-05,clear-day,Cinco de Mayo
414,221,193,2018-03-14,partly-cloudy-night,nan
117,58,59,2018-03-30,partly-cloudy-day,nan
336,162,174,2018-04-25,rain,nan
1523,788,735,2018-02-17,clear-day,nan
510,244,266,2018-06-07,cloudy,nan
160,82,78,2018-03-24,clear-day,nan
1728,991,737,2018-05-29,clear-day,nan
3587,1472,2115,2018-04-14,clear-day,nan
20,10,10,2018-02-22,cloudy,nan
1524,879,645,2018-04-29,partly-cloudy-day,nan
35,24,11,2018-03-17,clear-night,St. Patrick's Day
62,24,38,2018-03-08,partly-cloudy-day,nan
26,9,17,2018-04-18,partly-cloudy-night,nan
30,14,16,2018-04-08,clear-night,nan
7,4,3,2018-03-29,partly-cloudy-night,nan
14,13,1,2018-03-02,partly-cloudy-night,nan
796,322,474,2018-04-19,partly-cloudy-day,nan
571,261,310,2018-05-16,rain,nan
169,137,32,2018-02-22,partly-cloudy-night,nan
1380,725,655,2018-05-27,partly-cloudy-day,nan
1677,766,911,2018-05-06,cloudy,nan
808,462,346,2018-02-26,partly-cloudy-day,nan
1147,440,707,2018-03-24,clear-day,nan
0,0,0,2018-04-19,partly-cloudy-night,nan
2552,1214,1338,2018-05-11,clear-day,nan
60,46,14,2018-02-22,partly-cloudy-night,nan
1726,798,928,2018-05-15,partly-cloudy-day,nan
27,15,12,2018-06-06,partly-cloudy-night,nan
0,0,0,2018-04-16,wind,nan
558,264,294,2018-04-16,partly-cloudy-day,nan
950,520,430,2018-04-27,cloudy,nan
1093,449,644,2018-05-22,partly-cloudy-day,nan
19,13,6,2018-03-23,clear-night,nan
255,131,124,2018-05-09,clear-night,nan
630,264,366,2018-05-10,partly-cloudy-night,nan
513,336,177,2018-04-30,partly-cloudy-day,nan
3235,1430,1805,2018-05-05,clear-day,Cinco de Mayo
1866,1104,762,2018-06-11,clear-day,nan
1910,1162,748,2018-05-23,clear-day,nan
108,48,60,2018-05-29,partly-cloudy-day,nan
354,137,217,2018-03-27,partly-cloudy-night,nan
794,486,308,2018-03-11,clear-day,Daylight Saving Time starts
56,16,40,2018-02-11,partly-cloudy-night,nan
468,191,277,2018-04-07,partly-cloudy-night,nan
251,130,121,2018-02-06,partly-cloudy-day,nan
717,326,391,2018-02-06,partly-cloudy-day,nan
12,7,5,2018-03-30,partly-cloudy-night,nan
2,0,2,2018-02-11,rain,nan
2,1,1,2018-05-23,rain,nan
518,185,333,2018-04-18,clear-night,nan
2041,867,1174,2018-06-07,partly-cloudy-day,nan
13,8,5,2018-02-16,partly-cloudy-night,nan
868,391,477,2018-04-10,partly-cloudy-day,nan
510,171,339,2018-04-26,partly-cloudy-day,nan
62,30,32,2018-02-06,clear-night,nan
1418,722,696,2018-03-12,partly-cloudy-day,nan
151,114,37,2018-02-11,rain,nan
2,0,2,2018-03-08,partly-cloudy-night,nan
526,238,288,2018-02-16,partly-cloudy-day,nan
111,89,22,2018-02-07,rain,nan
1748,919,829,2018-05-24,clear-day,nan
1301,590,711,2018-04-30,partly-cloudy-day,nan
98,70,28,2018-03-31,clear-night,nan
1405,641,764,2018-04-12,clear-day,nan
235,91,144,2018-05-29,clear-night,nan
90,53,37,2018-02-28,partly-cloudy-night,nan
1465,645,820,2018-02-12,partly-cloudy-day,nan
817,419,398,2018-03-05,partly-cloudy-night,nan
536,338,198,2018-02-17,clear-day,nan
448,281,167,2018-02-05,clear-night,nan
806,387,419,2018-02-23,partly-cloudy-day,nan
1754,781,973,2018-06-05,cloudy,nan
152,61,91,2018-04-03,partly-cloudy-day,nan
59,41,18,2018-05-21,clear-night,nan
5,4,1,2018-02-11,rain,nan
27,14,13,2018-05-15,partly-cloudy-night,nan
176,125,51,2018-04-14,clear-night,nan
1912,1003,909,2018-02-20,clear-day,nan
112,44,68,2018-03-07,sleet,nan
51,38,13,2018-05-10,cloudy,nan
0,0,0,2018-03-02,rain,nan
353,171,182,2018-03-01,clear-day,nan
5,4,1,2018-03-25,clear-night,nan
6,4,2,2018-03-11,partly-cloudy-night,Daylight Saving Time starts
994,457,537,2018-02-28,clear-day,nan
997,471,526,2018-03-14,partly-cloudy-day,nan
1954,844,1110,2018-03-17,clear-day,St. Patrick's Day
537,281,256,2018-02-12,partly-cloudy-day,nan
1755,963,792,2018-04-22,clear-day,nan
1692,786,906,2018-05-29,clear-day,nan
292,116,176,2018-02-22,rain,nan
1516,810,706,2018-06-08,partly-cloudy-day,nan
32,11,21,2018-03-19,clear-night,nan
43,20,23,2018-03-05,clear-night,nan
14,9,5,2018-02-13,clear-night,nan
101,56,45,2018-04-25,fog,nan
783,428,355,2018-02-21,clear-night,nan
886,489,397,2018-05-01,clear-day,nan
1,0,1,2018-06-04,cloudy,nan
1604,964,640,2018-06-07,cloudy,nan
1822,1002,820,2018-05-08,clear-day,nan
46,19,27,2018-03-07,sleet,nan
1767,811,956,2018-04-24,clear-day,nan
26,9,17,2018-02-05,clear-night,nan
372,143,229,2018-04-13,partly-cloudy-day,nan
766,378,388,2018-04-20,clear-day,nan
26,19,7,2018-04-03,cloudy,nan
77,49,28,2018-02-06,clear-night,nan
157,70,87,2018-06-01,cloudy,nan
52,28,24,2018-06-01,cloudy,nan
1,0,1,2018-03-12,clear-night,nan
108,50,58,2018-03-23,partly-cloudy-night,nan
164,68,96,2018-05-21,clear-day,nan
2458,1144,1314,2018-05-26,clear-day,nan
1794,712,1082,2018-06-03,partly-cloudy-day,nan
34,19,15,2018-05-07,clear-night,nan
16,11,5,2018-03-09,partly-cloudy-night,nan
121,57,64,2018-06-09,clear-day,nan
2085,1003,1082,2018-04-13,clear-day,nan
892,424,468,2018-05-19,cloudy,nan
172,118,54,2018-05-15,rain,nan
130,105,25,2018-02-16,clear-night,nan
9,7,2,2018-04-19,cloudy,nan
395,243,152,2018-04-14,wind,nan
1606,939,667,2018-04-26,clear-day,nan
479,268,211,2018-05-27,cloudy,nan
12,3,9,2018-04-30,partly-cloudy-night,nan
1951,955,996,2018-05-20,partly-cloudy-day,nan
22,18,4,2018-05-23,partly-cloudy-night,nan
51,34,17,2018-04-03,cloudy,nan
1,0,1,2018-03-08,partly-cloudy-night,nan
312,152,160,2018-03-13,snow,nan
1675,892,783,2018-03-11,clear-day,Daylight Saving Time starts
6,3,3,2018-03-01,partly-cloudy-night,nan
1573,762,811,2018-03-06,clear-day,nan
5,3,2,2018-03-01,clear-night,nan
3,1,2,2018-02-17,clear-night,nan
15,8,7,2018-04-10,cloudy,nan
313,148,165,2018-06-01,clear-night,nan
2944,1252,1692,2018-06-09,partly-cloudy-day,nan
127,99,28,2018-03-16,clear-night,nan
1670,784,886,2018-04-04,partly-cloudy-day,nan
186,79,107,2018-02-07,cloudy,nan
201,173,28,2018-02-09,clear-night,nan
559,200,359,2018-04-20,clear-night,nan
119,48,71,2018-04-16,partly-cloudy-night,nan
81,43,38,2018-05-15,partly-cloudy-night,nan
55,29,26,2018-05-29,cloudy,nan
263,139,124,2018-04-27,partly-cloudy-night,nan
367,172,195,2018-04-09,clear-day,nan
1467,905,562,2018-06-02,clear-day,nan
229,124,105,2018-03-23,partly-cloudy-night,nan
300,158,142,2018-02-16,clear-night,nan
1217,562,655,2018-02-13,clear-day,nan
312,186,126,2018-05-28,partly-cloudy-day,Memorial Day
347,171,176,2018-03-29,partly-cloudy-day,nan
0,0,0,2018-03-28,partly-cloudy-night,nan
796,414,382,2018-02-27,clear-night,nan
27,14,13,2018-04-08,clear-night,nan
1293,534,759,2018-06-02,clear-day,nan
335,241,94,2018-02-15,clear-night,nan
308,181,127,2018-05-04,clear-night,nan
2,0,2,2018-02-06,clear-night,nan
462,171,291,2018-06-08,clear-day,nan
67,32,35,2018-02-22,cloudy,nan
754,337,417,2018-03-03,partly-cloudy-night,nan
2945,1227,1718,2018-04-05,partly-cloudy-day,nan
30,18,12,2018-05-06,partly-cloudy-night,nan
11,7,4,2018-02-08,partly-cloudy-night,nan
325,104,221,2018-02-21,cloudy,nan
2234,1064,1170,2018-03-24,clear-day,nan
2210,840,1370,2018-04-08,partly-cloudy-day,nan
827,350,477,2018-02-05,clear-day,nan
1445,826,619,2018-05-07,partly-cloudy-day,nan
1776,848,928,2018-04-20,clear-day,nan
24,8,16,2018-06-11,cloudy,nan
1067,508,559,2018-04-15,cloudy,nan
767,368,399,2018-02-23,partly-cloudy-day,nan
6,1,5,2018-03-16,clear-night,nan
62,42,20,2018-02-20,clear-night,nan
87,35,52,2018-02-07,partly-cloudy-night,nan
2068,926,1142,2018-05-08,clear-day,nan
156,91,65,2018-02-28,partly-cloudy-night,nan
1333,564,769,2018-04-30,partly-cloudy-day,nan
106,65,41,2018-05-12,cloudy,nan
2,0,2,2018-04-17,partly-cloudy-night,Tax Day
3,2,1,2018-02-18,partly-cloudy-night,nan
2778,1290,1488,2018-05-11,clear-day,nan
3,1,2,2018-06-12,clear-night,nan
1842,902,940,2018-06-05,partly-cloudy-day,nan
103,89,14,2018-03-30,cloudy,nan
11,3,8,2018-05-12,cloudy,nan
4,2,2,2018-04-03,clear-night,nan
3372,1681,1691,2018-03-31,clear-day,nan
53,28,25,2018-03-02,rain,nan
149,82,67,2018-03-09,clear-night,nan
6,4,2,2018-02-11,cloudy,nan
11,6,5,2018-05-30,clear-night,nan
759,364,395,2018-03-06,partly-cloudy-night,nan
1540,862,678,2018-04-23,clear-day,nan
210,125,85,2018-02-25,cloudy,nan
9,5,4,2018-04-14,clear-night,nan
353,121,232,2018-06-07,cloudy,nan
15,5,10,2018-06-10,cloudy,nan
103,52,51,2018-04-18,cloudy,nan
2,1,1,2018-03-21,cloudy,nan
3,2,1,2018-03-23,clear-night,nan
1557,719,838,2018-03-28,partly-cloudy-day,nan
37,14,23,2018-04-29,partly-cloudy-night,nan
2982,1418,1564,2018-04-01,clear-day,Easter Sunday
2,1,1,2018-02-07,clear-night,nan
1435,746,689,2018-05-17,clear-day,nan
65,39,26,2018-05-31,partly-cloudy-night,nan
1727,952,775,2018-05-30,clear-day,nan
1821,935,886,2018-02-24,cloudy,nan
2237,1021,1216,2018-05-01,clear-day,nan
1246,565,681,2018-03-22,rain,nan
29,16,13,2018-02-19,clear-night,Presidents' Day (regional holiday)
1908,804,1104,2018-05-28,cloudy,Memorial Day
220,59,161,2018-05-06,partly-cloudy-day,nan
391,145,246,2018-04-19,partly-cloudy-day,nan
801,429,372,2018-03-22,clear-day,nan
249,190,59,2018-02-14,partly-cloudy-night,Valentine's Day
1456,873,583,2018-05-18,partly-cloudy-day,nan
3,2,1,2018-04-25,partly-cloudy-night,nan
197,80,117,2018-03-15,partly-cloudy-day,nan
923,343,580,2018-05-22,cloudy,nan
2156,1023,1133,2018-03-10,partly-cloudy-day,nan
1476,742,734,2018-02-12,clear-day,nan
4,0,4,2018-05-17,cloudy,nan
867,491,376,2018-03-29,partly-cloudy-day,nan
468,254,214,2018-03-06,clear-day,nan
43,26,17,2018-04-07,partly-cloudy-night,nan
5,1,4,2018-05-19,cloudy,nan
1352,673,679,2018-03-16,partly-cloudy-day,nan
250,106,144,2018-04-14,clear-day,nan
3,0,3,2018-03-28,partly-cloudy-night,nan
104,55,49,2018-05-23,partly-cloudy-day,nan
2874,1456,1418,2018-05-05,clear-day,Cinco de Mayo
165,76,89,2018-05-14,partly-cloudy-day,nan
2299,1044,1255,2018-05-12,cloudy,nan
1014,510,504,2018-04-02,partly-cloudy-day,nan
1648,699,949,2018-02-19,cloudy,Presidents' Day (regional holiday)
13,8,5,2018-04-15,rain,nan
1343,600,743,2018-02-27,clear-day,nan
981,485,496,2018-02-08,partly-cloudy-day,nan
483,292,191,2018-02-11,partly-cloudy-day,nan
13,7,6,2018-03-05,partly-cloudy-night,nan
3205,1371,1834,2018-05-20,partly-cloudy-day,nan
125,80,45,2018-03-08,partly-cloudy-night,nan
408,159,249,2018-03-17,clear-night,St. Patrick's Day
3,2,1,2018-03-02,rain,nan
1030,414,616,2018-03-26,clear-day,nan
686,300,386,2018-05-13,partly-cloudy-day,Mother's Day
1860,899,961,2018-05-02,partly-cloudy-day,nan
1203,698,505,2018-05-14,partly-cloudy-day,nan
168,76,92,2018-05-12,partly-cloudy-day,nan
14,8,6,2018-05-21,clear-night,nan
239,167,72,2018-02-12,clear-night,nan
991,520,471,2018-03-27,clear-day,nan
1428,875,553,2018-05-29,partly-cloudy-day,nan
516,219,297,2018-05-04,partly-cloudy-day,nan
1223,568,655,2018-03-14,clear-day,nan
140,112,28,2018-02-21,cloudy,nan
2036,990,1046,2018-05-27,cloudy,nan
20,10,10,2018-02-12,partly-cloudy-night,nan
2212,1017,1195,2018-03-11,clear-day,Daylight Saving Time starts
463,279,184,2018-02-09,partly-cloudy-night,nan
801,424,377,2018-03-05,partly-cloudy-day,nan
1861,1002,859,2018-05-21,clear-day,nan
110,60,50,2018-04-23,clear-night,nan
1765,864,901,2018-04-04,partly-cloudy-day,nan
2334,733,1601,2018-03-30,partly-cloudy-day,nan
26,13,13,2018-05-19,rain,nan
1,0,1,2018-02-14,partly-cloudy-night,Valentine's Day
3255,1292,1963,2018-05-05,clear-day,Cinco de Mayo
9,4,5,2018-05-26,clear-night,nan
215,80,135,2018-05-08,clear-night,nan
596,259,337,2018-05-02,partly-cloudy-night,nan
810,419,391,2018-02-16,clear-day,nan
324,135,189,2018-05-08,clear-day,nan
385,124,261,2018-05-15,partly-cloudy-day,nan
754,374,380,2018-05-25,clear-day,nan
510,284,226,2018-05-16,rain,nan
36,30,6,2018-04-24,partly-cloudy-night,nan
112,52,60,2018-05-19,fog,nan
2318,1179,1139,2018-06-09,clear-day,nan
1082,573,509,2018-03-09,clear-day,nan
2201,1057,1144,2018-06-11,clear-day,nan
553,214,339,2018-05-25,clear-night,nan
47,33,14,2018-05-16,cloudy,nan
1668,741,927,2018-03-23,clear-day,nan
1479,678,801,2018-04-11,partly-cloudy-day,nan
142,84,58,2018-04-21,clear-day,nan
2,1,1,2018-03-19,clear-night,nan
711,364,347,2018-02-22,partly-cloudy-day,nan
1266,616,650,2018-05-31,cloudy,nan
634,353,281,2018-02-08,clear-day,nan
1453,597,856,2018-04-09,clear-day,nan
11,9,2,2018-06-06,partly-cloudy-night,nan
617,318,299,2018-03-20,partly-cloudy-day,nan
46,30,16,2018-03-07,snow,nan
17,10,7,2018-04-02,snow,nan
1453,880,573,2018-05-03,clear-day,nan
995,476,519,2018-02-20,clear-night,nan
3,0,3,2018-05-10,partly-cloudy-night,nan
120,51,69,2018-04-12,partly-cloudy-night,nan
78,37,41,2018-03-18,clear-night,nan
1820,804,1016,2018-03-18,clear-day,nan
43,31,12,2018-05-11,clear-night,nan
2261,1041,1220,2018-04-26,clear-day,nan
6,4,2,2018-06-08,clear-night,nan
1976,923,1053,2018-05-09,clear-day,nan
14,11,3,2018-04-08,partly-cloudy-night,nan
646,330,316,2018-04-12,clear-night,nan
1153,484,669,2018-05-11,clear-night,nan
1112,532,580,2018-02-14,partly-cloudy-day,Valentine's Day
89,40,49,2018-04-10,partly-cloudy-day,nan
4,2,2,2018-02-20,cloudy,nan
68,38,30,2018-02-23,partly-cloudy-night,nan
16,6,10,2018-02-08,clear-night,nan
1178,560,618,2018-02-28,clear-day,nan
198,61,137,2018-02-05,partly-cloudy-day,nan
372,217,155,2018-04-17,partly-cloudy-day,Tax Day
34,13,21,2018-05-27,rain,nan
2121,1008,1113,2018-03-24,clear-day,nan
48,26,22,2018-02-15,partly-cloudy-night,nan
37,24,13,2018-05-04,partly-cloudy-night,nan
283,177,106,2018-06-03,partly-cloudy-day,nan
291,146,145,2018-04-19,partly-cloudy-night,nan
2023,971,1052,2018-06-07,clear-day,nan
18,10,8,2018-03-07,snow,nan
87,46,41,2018-02-18,clear-day,nan
1693,918,775,2018-06-07,clear-day,nan
85,45,40,2018-02-26,clear-night,nan
774,375,399,2018-03-13,partly-cloudy-day,nan
921,504,417,2018-02-06,cloudy,nan
12,9,3,2018-03-04,partly-cloudy-night,nan
781,373,408,2018-03-20,partly-cloudy-day,nan
9,3,6,2018-04-21,clear-night,nan
2,1,1,2018-02-23,cloudy,nan
3,2,1,2018-06-04,rain,nan
1369,726,643,2018-06-01,clear-day,nan
6,2,4,2018-02-09,clear-night,nan
46,31,15,2018-03-02,partly-cloudy-day,nan
1630,770,860,2018-02-17,partly-cloudy-day,nan
574,279,295,2018-03-23,partly-cloudy-day,nan
5,4,1,2018-05-15,partly-cloudy-night,nan
143,55,88,2018-02-16,partly-cloudy-day,nan
88,55,33,2018-04-16,rain,nan
1777,939,838,2018-06-05,partly-cloudy-day,nan
994,455,539,2018-02-13,clear-day,nan
1378,605,773,2018-04-11,clear-day,nan
1,0,1,2018-03-02,rain,nan
1709,774,935,2018-06-04,partly-cloudy-day,nan
531,279,252,2018-04-03,partly-cloudy-day,nan
18,10,8,2018-04-06,clear-night,nan
2180,1018,1162,2018-05-07,clear-day,nan
11,3,8,2018-04-28,partly-cloudy-night,nan
4058,1980,2078,2018-03-31,clear-day,nan
3,1,2,2018-03-13,partly-cloudy-night,nan
26,8,18,2018-05-02,clear-night,nan
15,9,6,2018-03-26,clear-night,nan
0,0,0,2018-03-14,clear-night,nan
1010,444,566,2018-04-15,wind,nan
358,151,207,2018-05-06,partly-cloudy-night,nan
107,102,5,2018-02-24,partly-cloudy-night,nan
2172,980,1192,2018-06-02,clear-day,nan
331,173,158,2018-03-10,cloudy,nan
107,47,60,2018-05-06,partly-cloudy-night,nan
5,3,2,2018-02-21,cloudy,nan
119,65,54,2018-04-24,clear-night,nan
207,79,128,2018-04-07,cloudy,nan
873,444,429,2018-02-25,partly-cloudy-day,nan
1093,627,466,2018-04-30,partly-cloudy-day,nan
37,27,10,2018-06-02,clear-night,nan
2,1,1,2018-03-22,snow,nan
2253,1060,1193,2018-05-25,clear-day,nan
188,94,94,2018-03-03,clear-day,nan
236,114,122,2018-05-30,cloudy,nan
1059,453,606,2018-03-08,snow,nan
643,246,397,2018-04-01,clear-night,Easter Sunday
2118,954,1164,2018-05-24,clear-day,nan
1800,987,813,2018-05-24,clear-day,nan
5,1,4,2018-06-11,partly-cloudy-night,nan
999,622,377,2018-02-19,clear-day,Presidents' Day (regional holiday)
444,213,231,2018-03-12,partly-cloudy-night,nan
232,77,155,2018-02-20,fog,nan
516,145,371,2018-06-12,clear-day,nan
92,43,49,2018-04-10,clear-night,nan
14,7,7,2018-02-28,clear-night,nan
2154,1325,829,2018-05-12,rain,nan
1600,883,717,2018-05-04,clear-day,nan
320,127,193,2018-02-27,clear-day,nan
1097,571,526,2018-05-13,rain,Mother's Day
1640,1064,576,2018-05-25,clear-day,nan
50,24,26,2018-03-11,partly-cloudy-night,Daylight Saving Time starts
186,66,120,2018-02-09,clear-day,nan
51,28,23,2018-03-02,rain,nan
66,43,23,2018-05-04,partly-cloudy-night,nan
1926,1080,846,2018-02-18,clear-day,nan
326,219,107,2018-04-13,clear-night,nan
13,9,4,2018-04-29,cloudy,nan
325,122,203,2018-05-31,cloudy,nan
1917,869,1048,2018-05-10,partly-cloudy-day,nan
171,78,93,2018-05-10,partly-cloudy-day,nan
282,136,146,2018-04-21,clear-night,nan
9,5,4,2018-04-18,partly-cloudy-night,nan
259,142,117,2018-03-01,partly-cloudy-night,nan
60,56,4,2018-02-10,rain,nan
228,123,105,2018-03-10,clear-day,nan
445,220,225,2018-04-25,rain,nan
125,78,47,2018-02-13,partly-cloudy-night,nan
1615,948,667,2018-03-25,partly-cloudy-day,nan
57,16,41,2018-03-07,partly-cloudy-day,nan
206,89,117,2018-05-17,clear-night,nan
14,5,9,2018-03-02,partly-cloudy-night,nan
261,138,123,2018-05-30,partly-cloudy-night,nan
165,137,28,2018-02-08,partly-cloudy-night,nan
2123,1019,1104,2018-04-23,clear-day,nan
2,0,2,2018-02-25,partly-cloudy-night,nan
323,178,145,2018-03-12,clear-day,nan
18,10,8,2018-03-06,clear-night,nan
1423,857,566,2018-02-26,clear-day,nan
48,46,2,2018-02-07,rain,nan
1764,839,925,2018-06-11,clear-day,nan
1,0,1,2018-02-15,partly-cloudy-night,nan
1100,501,599,2018-02-15,partly-cloudy-day,nan
1027,482,545,2018-05-16,partly-cloudy-day,nan
755,344,411,2018-06-06,partly-cloudy-day,nan
2878,1299,1579,2018-04-22,clear-day,nan
74,62,12,2018-04-01,partly-cloudy-night,Easter Sunday
11,6,5,2018-06-01,cloudy,nan
18,12,6,2018-05-24,clear-night,nan
58,23,35,2018-03-19,clear-night,nan
199,78,121,2018-03-14,clear-day,nan
113,56,57,2018-06-10,partly-cloudy-day,nan
178,96,82,2018-03-24,partly-cloudy-night,nan
3,1,2,2018-03-17,clear-night,St. Patrick's Day
1393,753,640,2018-06-04,partly-cloudy-day,nan
3,2,1,2018-03-03,partly-cloudy-night,nan
1,0,1,2018-03-15,partly-cloudy-night,nan
5,2,3,2018-04-02,partly-cloudy-night,nan
196,110,86,2018-04-10,clear-night,nan
4,0,4,2018-03-09,partly-cloudy-night,nan
155,71,84,2018-05-21,clear-night,nan
278,130,148,2018-04-06,partly-cloudy-night,nan
1719,1015,704,2018-05-11,clear-day,nan
382,218,164,2018-05-26,clear-day,nan
205,99,106,2018-03-16,clear-day,nan
1538,696,842,2018-03-19,clear-day,nan
505,229,276,2018-05-09,clear-night,nan
72,41,31,2018-05-27,clear-night,nan
194,84,110,2018-03-30,partly-cloudy-night,nan
87,75,12,2018-05-10,partly-cloudy-night,nan
989,569,420,2018-05-22,partly-cloudy-day,nan
107,50,57,2018-03-04,partly-cloudy-night,nan
370,178,192,2018-02-11,rain,nan
15,9,6,2018-06-07,cloudy,nan
136,52,84,2018-02-13,clear-day,nan
2,1,1,2018-03-26,clear-night,nan
564,264,300,2018-04-03,rain,nan
2523,1181,1342,2018-05-18,clear-day,nan
274,114,160,2018-06-08,partly-cloudy-night,nan
1013,524,489,2018-02-09,partly-cloudy-day,nan
580,323,257,2018-02-18,clear-night,nan
10,8,2,2018-05-13,cloudy,Mother's Day
1703,867,836,2018-06-03,partly-cloudy-day,nan
98,48,50,2018-02-24,partly-cloudy-day,nan
240,169,71,2018-03-15,partly-cloudy-night,nan
22,10,12,2018-03-21,partly-cloudy-night,nan
239,132,107,2018-04-27,partly-cloudy-day,nan
131,39,92,2018-05-28,cloudy,Memorial Day
472,177,295,2018-06-06,partly-cloudy-day,nan
529,253,276,2018-04-21,clear-night,nan
557,302,255,2018-03-23,clear-day,nan
1859,994,865,2018-05-23,partly-cloudy-day,nan
14,5,9,2018-04-16,rain,nan
6,2,4,2018-03-15,partly-cloudy-night,nan
1323,600,723,2018-03-05,cloudy,nan
811,404,407,2018-02-26,clear-night,nan
495,246,249,2018-03-25,partly-cloudy-night,nan
583,349,234,2018-05-31,partly-cloudy-day,nan
42,21,21,2018-03-18,clear-night,nan
2022,942,1080,2018-05-02,partly-cloudy-day,nan
296,163,133,2018-05-16,rain,nan
53,36,17,2018-03-26,clear-night,nan
1605,818,787,2018-02-10,partly-cloudy-day,nan
1919,819,1100,2018-04-22,clear-day,nan
2,1,1,2018-04-04,cloudy,nan
2079,1050,1029,2018-05-17,clear-day,nan
261,103,158,2018-04-26,partly-cloudy-day,nan
1952,997,955,2018-02-21,clear-day,nan
1748,973,775,2018-06-08,clear-day,nan
2258,1029,1229,2018-05-14,partly-cloudy-day,nan
1681,880,801,2018-04-07,partly-cloudy-day,nan
71,58,13,2018-05-13,partly-cloudy-night,Mother's Day
1951,919,1032,2018-05-29,clear-day,nan
11,6,5,2018-05-16,partly-cloudy-night,nan
1199,525,674,2018-04-12,partly-cloudy-day,nan
280,122,158,2018-04-16,partly-cloudy-night,nan
59,38,21,2018-05-08,clear-night,nan
107,99,8,2018-03-17,clear-night,St. Patrick's Day
1838,835,1003,2018-05-06,cloudy,nan
1841,724,1117,2018-03-27,clear-day,nan
3,2,1,2018-03-09,partly-cloudy-night,nan
1931,930,1001,2018-03-11,clear-day,Daylight Saving Time starts
9,2,7,2018-06-03,partly-cloudy-night,nan
2517,1116,1401,2018-05-01,clear-day,nan
100,42,58,2018-05-31,partly-cloudy-day,nan
1945,893,1052,2018-03-03,clear-day,nan
774,358,416,2018-03-20,partly-cloudy-day,nan
222,83,139,2018-05-22,clear-day,nan
11,5,6,2018-03-06,clear-night,nan
124,62,62,2018-03-28,partly-cloudy-night,nan
762,511,251,2018-05-19,rain,nan
94,48,46,2018-03-21,snow,nan
733,327,406,2018-02-16,partly-cloudy-day,nan
53,27,26,2018-04-06,partly-cloudy-night,nan
1239,619,620,2018-04-09,partly-cloudy-day,nan
78,51,27,2018-05-25,clear-night,nan
1,0,1,2018-03-13,partly-cloudy-night,nan
189,110,79,2018-05-02,partly-cloudy-night,nan
1220,520,700,2018-03-09,partly-cloudy-day,nan
3050,1498,1552,2018-04-14,clear-day,nan
18,11,7,2018-05-05,clear-night,Cinco de Mayo
8,6,2,2018-02-24,cloudy,nan
207,93,114,2018-03-13,clear-night,nan
39,19,20,2018-05-02,clear-night,nan
2282,1201,1081,2018-05-14,clear-day,nan
273,94,179,2018-03-19,clear-day,nan
15,7,8,2018-03-26,clear-night,nan
218,66,152,2018-02-14,partly-cloudy-day,Valentine's Day
44,18,26,2018-03-02,rain,nan
7,6,1,2018-06-07,cloudy,nan
1273,726,547,2018-02-21,partly-cloudy-day,nan
10,4,6,2018-03-18,clear-night,nan
138,95,43,2018-02-17,snow,nan
861,474,387,2018-05-11,clear-day,nan
750,417,333,2018-02-10,rain,nan
1001,518,483,2018-03-23,clear-day,nan
2038,923,1115,2018-06-01,partly-cloudy-day,nan
1413,600,813,2018-06-10,cloudy,nan
1031,424,607,2018-02-28,clear-day,nan
18,7,11,2018-04-20,clear-night,nan
23,13,10,2018-05-24,clear-night,nan
1729,755,974,2018-05-09,clear-day,nan
1591,742,849,2018-03-18,clear-day,nan
1854,922,932,2018-05-30,clear-day,nan
503,181,322,2018-04-05,clear-night,nan
1943,998,945,2018-05-25,clear-day,nan
163,70,93,2018-04-30,partly-cloudy-day,nan
1988,990,998,2018-02-17,clear-day,nan
2422,1048,1374,2018-04-07,partly-cloudy-day,nan
2497,1163,1334,2018-05-21,clear-day,nan
1758,706,1052,2018-05-03,partly-cloudy-day,nan
1149,541,608,2018-02-14,partly-cloudy-day,Valentine's Day
50,31,19,2018-04-17,partly-cloudy-night,Tax Day
228,99,129,2018-04-02,clear-night,nan
2284,1065,1219,2018-06-08,partly-cloudy-day,nan
1709,814,895,2018-05-15,clear-day,nan
9,4,5,2018-03-29,cloudy,nan
513,355,158,2018-04-08,clear-day,nan
109,36,73,2018-05-12,partly-cloudy-night,nan
3,0,3,2018-02-16,partly-cloudy-night,nan
1267,598,669,2018-03-12,clear-day,nan
33,12,21,2018-03-22,clear-night,nan
4,1,3,2018-02-26,partly-cloudy-night,nan
169,74,95,2018-06-10,clear-night,nan
708,265,443,2018-05-05,clear-night,Cinco de Mayo
126,59,67,2018-02-23,partly-cloudy-day,nan
29,17,12,2018-05-08,clear-night,nan
20,10,10,2018-02-23,partly-cloudy-night,nan
4,2,2,2018-02-15,partly-cloudy-night,nan
294,145,149,2018-02-08,clear-day,nan
50,34,16,2018-03-04,cloudy,nan
996,472,524,2018-04-16,partly-cloudy-day,nan
1013,527,486,2018-03-15,clear-day,nan
16,6,10,2018-02-12,partly-cloudy-night,nan
57,29,28,2018-05-28,cloudy,Memorial Day
742,417,325,2018-06-09,clear-day,nan
74,33,41,2018-04-28,partly-cloudy-night,nan
718,354,364,2018-02-06,partly-cloudy-day,nan
52,29,23,2018-04-21,clear-night,nan
255,113,142,2018-05-02,clear-day,nan
1546,693,853,2018-06-04,cloudy,nan
1380,674,706,2018-03-04,partly-cloudy-day,nan
2508,1282,1226,2018-05-20,partly-cloudy-day,nan
2,0,2,2018-04-11,clear-night,nan
2788,1165,1623,2018-04-29,partly-cloudy-day,nan
131,77,54,2018-04-04,clear-night,nan
451,279,172,2018-02-24,partly-cloudy-night,nan
32,12,20,2018-03-21,snow,nan
1823,939,884,2018-04-13,clear-day,nan
1126,665,461,2018-06-10,partly-cloudy-day,nan
2384,1008,1376,2018-05-01,clear-day,nan
0,0,0,2018-03-07,partly-cloudy-night,nan
30,16,14,2018-04-27,clear-night,nan
10,7,3,2018-03-20,clear-night,nan
518,196,322,2018-05-09,clear-day,nan
249,146,103,2018-02-25,rain,nan
4,2,2,2018-03-05,partly-cloudy-night,nan
1558,883,675,2018-06-06,cloudy,nan
386,159,227,2018-06-11,partly-cloudy-day,nan
817,461,356,2018-06-02,clear-day,nan
19,11,8,2018-04-12,partly-cloudy-night,nan
1805,1128,677,2018-04-21,clear-day,nan
26,10,16,2018-06-08,clear-night,nan
98,44,54,2018-04-15,cloudy,nan
179,80,99,2018-05-24,clear-night,nan
738,323,415,2018-05-03,clear-day,nan
1101,649,452,2018-03-31,clear-day,nan
4,1,3,2018-04-24,clear-night,nan
107,79,28,2018-02-22,partly-cloudy-night,nan
105,41,64,2018-04-19,rain,nan
1976,916,1060,2018-03-25,partly-cloudy-day,nan
687,273,414,2018-05-03,rain,nan
4,0,4,2018-03-27,clear-night,nan
460,254,206,2018-03-27,clear-day,nan
1008,467,541,2018-03-01,clear-day,nan
111,82,29,2018-02-11,partly-cloudy-night,nan
2,1,1,2018-02-27,clear-night,nan
328,173,155,2018-03-16,clear-day,nan
41,22,19,2018-05-27,clear-night,nan
3,2,1,2018-04-07,cloudy,nan
2084,921,1163,2018-06-09,clear-day,nan
3,1,2,2018-03-10,clear-night,nan
2251,972,1279,2018-05-12,cloudy,nan
36,16,20,2018-06-01,cloudy,nan
1685,785,900,2018-05-10,clear-day,nan
433,227,206,2018-03-05,partly-cloudy-day,nan
1652,757,895,2018-03-04,partly-cloudy-day,nan
2898,1415,1483,2018-05-26,clear-day,nan
65,26,39,2018-05-19,cloudy,nan
199,148,51,2018-02-27,clear-night,nan
252,128,124,2018-04-25,rain,nan
13,10,3,2018-04-05,clear-night,nan
1700,872,828,2018-03-15,partly-cloudy-day,nan
125,43,82,2018-04-30,partly-cloudy-night,nan
1747,811,936,2018-02-20,clear-day,nan
1144,623,521,2018-02-15,clear-day,nan
151,79,72,2018-06-04,clear-night,nan
357,232,125,2018-05-20,partly-cloudy-day,nan
0,0,0,2018-04-16,rain,nan
49,26,23,2018-03-30,partly-cloudy-night,nan
2003,917,1086,2018-05-04,partly-cloudy-day,nan
1,0,1,2018-05-09,clear-night,nan
136,55,81,2018-03-24,clear-day,nan
21,10,11,2018-03-04,partly-cloudy-night,nan
452,277,175,2018-02-13,clear-night,nan
39,20,19,2018-02-25,rain,nan
20,11,9,2018-05-18,clear-night,nan
709,374,335,2018-02-09,partly-cloudy-day,nan
166,74,92,2018-03-10,partly-cloudy-night,nan
63,35,28,2018-04-08,clear-night,nan
2,0,2,2018-03-22,snow,nan
37,22,15,2018-03-08,clear-night,nan
54,20,34,2018-06-07,cloudy,nan
2134,969,1165,2018-05-25,clear-day,nan
46,40,6,2018-04-28,rain,nan
29,14,15,2018-06-12,clear-night,nan
33,31,2,2018-03-02,rain,nan
1224,583,641,2018-02-26,partly-cloudy-day,nan
486,186,300,2018-05-27,cloudy,nan
1389,693,696,2018-05-07,partly-cloudy-day,nan
5,4,1,2018-03-16,clear-night,nan
357,113,244,2018-04-01,clear-night,Easter Sunday
109,45,64,2018-02-19,clear-day,Presidents' Day (regional holiday)
1,1,0,2018-02-10,partly-cloudy-night,nan
642,344,298,2018-04-07,partly-cloudy-day,nan
51,32,19,2018-05-13,cloudy,Mother's Day
1839,832,1007,2018-03-24,clear-day,nan
2398,1111,1287,2018-06-03,partly-cloudy-day,nan
1022,495,527,2018-03-19,clear-day,nan
24,14,10,2018-05-10,partly-cloudy-night,nan
216,93,123,2018-05-22,partly-cloudy-night,nan
167,92,75,2018-05-24,clear-day,nan
1181,503,678,2018-04-27,partly-cloudy-day,nan
98,60,38,2018-02-19,partly-cloudy-night,Presidents' Day (regional holiday)
944,408,536,2018-03-08,partly-cloudy-day,nan
4,2,2,2018-02-28,clear-night,nan
1035,470,565,2018-06-05,partly-cloudy-day,nan
424,281,143,2018-03-17,clear-day,St. Patrick's Day
0,0,0,2018-02-24,partly-cloudy-night,nan
56,34,22,2018-03-26,clear-night,nan
357,237,120,2018-03-11,clear-day,Daylight Saving Time starts
123,50,73,2018-03-11,clear-night,Daylight Saving Time starts
1096,571,525,2018-04-10,partly-cloudy-day,nan
2150,931,1219,2018-05-23,clear-day,nan
3,1,2,2018-02-13,clear-night,nan
7,6,1,2018-02-11,rain,nan
494,282,212,2018-03-20,partly-cloudy-day,nan
2102,975,1127,2018-06-07,clear-day,nan
2418,1074,1344,2018-05-20,partly-cloudy-day,nan
44,18,26,2018-05-23,partly-cloudy-night,nan
174,95,79,2018-04-22,clear-night,nan
870,357,513,2018-04-10,partly-cloudy-day,nan
359,211,148,2018-03-09,partly-cloudy-day,nan
299,130,169,2018-04-18,clear-night,nan
141,112,29,2018-04-20,clear-night,nan
1643,882,761,2018-05-11,clear-day,nan
3,0,3,2018-02-07,clear-night,nan
127,52,75,2018-02-26,clear-night,nan
1391,603,788,2018-03-06,partly-cloudy-day,nan
123,74,49,2018-02-28,clear-night,nan
466,237,229,2018-03-18,clear-night,nan
644,303,341,2018-04-19,partly-cloudy-day,nan
28,14,14,2018-03-01,clear-night,nan
1295,636,659,2018-03-12,partly-cloudy-day,nan
8,6,2,2018-05-29,cloudy,nan
319,158,161,2018-03-05,partly-cloudy-night,nan
21,16,5,2018-04-09,clear-night,nan
69,41,28,2018-02-07,rain,nan
188,72,116,2018-06-04,cloudy,nan
1480,639,841,2018-04-12,partly-cloudy-day,nan
1462,722,740,2018-03-03,partly-cloudy-day,nan
708,405,303,2018-04-27,cloudy,nan
152,75,77,2018-05-15,partly-cloudy-night,nan
1120,601,519,2018-03-19,clear-day,nan
204,96,108,2018-02-17,clear-day,nan
229,153,76,2018-02-05,clear-night,nan
202,117,85,2018-03-21,snow,nan
82,37,45,2018-03-13,partly-cloudy-day,nan
579,238,341,2018-05-26,clear-night,nan
871,534,337,2018-03-06,clear-day,nan
296,207,89,2018-02-16,clear-night,nan
38,20,18,2018-06-09,clear-night,nan
5,4,1,2018-04-13,clear-night,nan
48,26,22,2018-05-15,partly-cloudy-night,nan
13,6,7,2018-03-25,clear-night,nan
6,3,3,2018-03-28,partly-cloudy-night,nan
22,11,11,2018-02-11,rain,nan
570,185,385,2018-05-01,clear-night,nan
1886,875,1011,2018-04-18,clear-day,nan
443,198,245,2018-04-04,fog,nan
1211,557,654,2018-03-06,clear-day,nan
719,365,354,2018-05-07,partly-cloudy-day,nan
28,19,9,2018-03-14,clear-night,nan
105,38,67,2018-02-22,cloudy,nan
1555,735,820,2018-03-17,clear-day,St. Patrick's Day
17,9,8,2018-02-09,clear-night,nan
181,70,111,2018-04-11,clear-day,nan
475,235,240,2018-05-05,clear-day,Cinco de Mayo
321,128,193,2018-04-29,partly-cloudy-night,nan
268,186,82,2018-04-12,clear-night,nan
751,310,441,2018-05-23,clear-night,nan
2586,1259,1327,2018-02-18,clear-day,nan
3469,1532,1937,2018-04-14,clear-day,nan
766,338,428,2018-05-29,clear-night,nan
363,179,184,2018-04-26,clear-night,nan
554,248,306,2018-03-16,clear-night,nan
24,15,9,2018-03-29,partly-cloudy-night,nan
3,2,1,2018-03-07,sleet,nan
2102,1017,1085,2018-05-27,cloudy,nan
198,74,124,2018-05-20,clear-night,nan
13,7,6,2018-04-03,clear-night,nan
1878,808,1070,2018-05-06,partly-cloudy-day,nan
43,36,7,2018-04-20,partly-cloudy-night,nan
3171,1066,2105,2018-06-02,clear-day,nan
3,0,3,2018-04-19,cloudy,nan
344,131,213,2018-05-16,cloudy,nan
232,154,78,2018-03-29,fog,nan
1589,784,805,2018-06-12,clear-day,nan
1692,824,868,2018-05-15,clear-day,nan
672,349,323,2018-05-29,partly-cloudy-day,nan
325,189,136,2018-04-09,partly-cloudy-night,nan
8,6,2,2018-02-22,cloudy,nan
117,52,65,2018-03-28,partly-cloudy-day,nan
1309,563,746,2018-06-03,partly-cloudy-day,nan
236,112,124,2018-04-07,partly-cloudy-night,nan
76,24,52,2018-05-06,partly-cloudy-night,nan
64,57,7,2018-02-16,partly-cloudy-night,nan
513,231,282,2018-03-22,clear-day,nan
12,6,6,2018-02-17,snow,nan
707,299,408,2018-06-05,clear-day,nan
5,4,1,2018-06-05,clear-night,nan
150,92,58,2018-06-03,partly-cloudy-night,nan
822,517,305,2018-03-18,clear-day,nan
15,13,2,2018-05-28,cloudy,Memorial Day
2702,1330,1372,2018-05-26,clear-day,nan
308,118,190,2018-04-17,partly-cloudy-day,Tax Day
698,299,399,2018-06-10,partly-cloudy-day,nan
1715,823,892,2018-05-30,cloudy,nan
2,0,2,2018-02-07,clear-night,nan
46,29,17,2018-03-20,partly-cloudy-night,nan
1858,829,1029,2018-04-08,partly-cloudy-day,nan
9,4,5,2018-05-23,partly-cloudy-night,nan
38,34,4,2018-02-07,partly-cloudy-night,nan
227,86,141,2018-02-13,clear-day,nan
1,0,1,2018-03-05,partly-cloudy-night,nan
59,35,24,2018-05-03,clear-night,nan
2315,1156,1159,2018-04-20,clear-day,nan
603,225,378,2018-04-28,rain,nan
1410,640,770,2018-04-17,partly-cloudy-day,Tax Day
1988,1062,926,2018-05-08,clear-day,nan
219,108,111,2018-05-18,partly-cloudy-day,nan
2107,977,1130,2018-04-05,partly-cloudy-day,nan
132,52,80,2018-05-06,partly-cloudy-day,nan
3209,1494,1715,2018-04-21,clear-day,nan
15,9,6,2018-03-31,partly-cloudy-night,nan
1441,710,731,2018-04-06,partly-cloudy-day,nan
176,65,111,2018-04-14,clear-night,nan
43,12,31,2018-05-28,cloudy,Memorial Day
936,472,464,2018-02-12,partly-cloudy-day,nan
1713,872,841,2018-06-06,cloudy,nan
55,45,10,2018-03-10,clear-night,nan
1622,875,747,2018-02-12,clear-day,nan
420,266,154,2018-02-18,clear-night,nan
2175,950,1225,2018-03-26,clear-day,nan
3210,1411,1799,2018-05-28,partly-cloudy-day,Memorial Day
1762,899,863,2018-03-26,clear-day,nan
398,219,179,2018-02-23,cloudy,nan
840,401,439,2018-02-05,clear-day,nan
139,57,82,2018-03-20,clear-night,nan
521,292,229,2018-03-01,clear-day,nan
1149,633,516,2018-02-20,cloudy,nan
109,94,15,2018-03-06,partly-cloudy-night,nan
31,18,13,2018-02-25,partly-cloudy-night,nan
151,49,102,2018-04-23,clear-night,nan
15,4,11,2018-03-12,clear-night,nan
1358,835,523,2018-04-20,clear-day,nan
6,3,3,2018-06-11,cloudy,nan
42,23,19,2018-05-17,rain,nan
1759,791,968,2018-03-29,cloudy,nan
1531,700,831,2018-03-28,partly-cloudy-day,nan
213,128,85,2018-02-24,partly-cloudy-day,nan
1217,756,461,2018-05-13,cloudy,Mother's Day
242,128,114,2018-05-10,rain,nan
226,111,115,2018-02-10,partly-cloudy-day,nan
2010,969,1041,2018-05-08,clear-day,nan
3539,1703,1836,2018-04-28,partly-cloudy-day,nan
2111,1103,1008,2018-05-04,clear-day,nan
260,166,94,2018-03-31,clear-night,nan
167,76,91,2018-04-22,clear-day,nan
699,331,368,2018-04-19,partly-cloudy-day,nan
4,3,1,2018-02-19,clear-night,Presidents' Day (regional holiday)
17,11,6,2018-04-25,cloudy,nan
8,6,2,2018-03-22,partly-cloudy-night,nan
1165,469,696,2018-02-24,partly-cloudy-day,nan
9,2,7,2018-03-01,partly-cloudy-night,nan
0,0,0,2018-04-15,cloudy,nan
417,185,232,2018-05-12,rain,nan
0,0,0,2018-04-10,partly-cloudy-night,nan
3530,1681,1849,2018-05-28,partly-cloudy-day,Memorial Day
938,532,406,2018-05-19,cloudy,nan
1339,583,756,2018-03-16,partly-cloudy-day,nan
8,7,1,2018-05-22,clear-night,nan
481,174,307,2018-05-24,clear-day,nan
66,40,26,2018-06-06,partly-cloudy-night,nan
1755,861,894,2018-03-10,cloudy,nan
3,2,1,2018-04-16,partly-cloudy-night,nan
57,33,24,2018-05-01,partly-cloudy-night,nan
29,21,8,2018-02-20,fog,nan
4,1,3,2018-03-24,partly-cloudy-night,nan
337,128,209,2018-04-11,clear-night,nan
2434,1121,1313,2018-03-30,partly-cloudy-day,nan
1488,755,733,2018-04-18,partly-cloudy-day,nan
637,294,343,2018-03-27,partly-cloudy-day,nan
1968,1175,793,2018-06-11,clear-day,nan
2800,1183,1617,2018-04-01,partly-cloudy-day,Easter Sunday
208,102,106,2018-03-03,cloudy,nan
530,190,340,2018-05-18,cloudy,nan
224,114,110,2018-03-27,partly-cloudy-night,nan
2,1,1,2018-05-14,cloudy,nan
1264,637,627,2018-02-27,clear-day,nan
270,193,77,2018-03-14,partly-cloudy-night,nan
197,53,144,2018-02-06,partly-cloudy-day,nan
885,575,310,2018-05-27,cloudy,nan
2144,1109,1035,2018-05-01,clear-day,nan
954,366,588,2018-04-04,partly-cloudy-day,nan
1363,696,667,2018-04-02,rain,nan
2017,989,1028,2018-05-09,clear-day,nan
2663,1207,1456,2018-04-26,clear-day,nan
564,223,341,2018-06-07,partly-cloudy-night,nan
905,343,562,2018-05-16,partly-cloudy-day,nan
20,11,9,2018-05-20,fog,nan
6,4,2,2018-03-08,partly-cloudy-night,nan
182,54,128,2018-04-10,partly-cloudy-day,nan
354,210,144,2018-04-19,partly-cloudy-day,nan
15,10,5,2018-02-19,clear-night,Presidents' Day (regional holiday)
3,2,1,2018-04-25,partly-cloudy-night,nan
3,1,2,2018-04-23,clear-night,nan
580,294,286,2018-03-29,fog,nan
115,63,52,2018-06-03,partly-cloudy-day,nan
409,179,230,2018-05-22,partly-cloudy-day,nan
21,13,8,2018-05-04,clear-night,nan
265,90,175,2018-03-06,clear-day,nan
2615,1229,1386,2018-03-24,clear-day,nan
4,1,3,2018-05-17,cloudy,nan
2681,1290,1391,2018-06-09,clear-day,nan
6,3,3,2018-04-10,partly-cloudy-night,nan
3831,1846,1985,2018-04-28,clear-day,nan
584,371,213,2018-03-04,cloudy,nan
3,2,1,2018-04-21,clear-night,nan
1315,601,714,2018-03-19,clear-day,nan
59,28,31,2018-04-16,partly-cloudy-night,nan
7,4,3,2018-05-15,cloudy,nan
39,24,15,2018-03-02,rain,nan
60,28,32,2018-05-22,clear-night,nan
170,141,29,2018-03-27,partly-cloudy-night,nan
354,219,135,2018-02-11,rain,nan
2331,1077,1254,2018-03-30,partly-cloudy-day,nan
150,74,76,2018-06-09,partly-cloudy-night,nan
333,247,86,2018-04-02,snow,nan
63,38,25,2018-05-11,clear-night,nan
85,37,48,2018-05-14,partly-cloudy-day,nan
0,0,0,2018-03-02,rain,nan
650,370,280,2018-04-27,rain,nan
1886,948,938,2018-06-03,partly-cloudy-day,nan
1759,1016,743,2018-05-05,clear-day,Cinco de Mayo
132,65,67,2018-04-07,partly-cloudy-night,nan
23,19,4,2018-04-28,partly-cloudy-night,nan
1873,786,1087,2018-05-12,cloudy,nan
104,68,36,2018-03-20,partly-cloudy-night,nan
61,37,24,2018-05-29,cloudy,nan
730,297,433,2018-04-08,partly-cloudy-day,nan
1855,850,1005,2018-05-23,partly-cloudy-day,nan
3,2,1,2018-03-13,partly-cloudy-night,nan
126,59,67,2018-04-18,clear-night,nan
912,400,512,2018-02-05,clear-day,nan
2847,1304,1543,2018-04-05,partly-cloudy-day,nan
1580,668,912,2018-04-08,partly-cloudy-day,nan
80,28,52,2018-03-07,partly-cloudy-day,nan
7,2,5,2018-02-08,partly-cloudy-night,nan
8,4,4,2018-04-12,partly-cloudy-night,nan
299,116,183,2018-02-12,partly-cloudy-day,nan
1515,798,717,2018-03-22,clear-day,nan
973,366,607,2018-03-17,clear-day,St. Patrick's Day
2707,1282,1425,2018-03-24,clear-day,nan
5,0,5,2018-02-21,partly-cloudy-night,nan
2901,1297,1604,2018-05-20,clear-day,nan
923,370,553,2018-04-15,wind,nan
182,73,109,2018-04-20,clear-night,nan
10,7,3,2018-06-11,cloudy,nan
9,5,4,2018-06-04,cloudy,nan
343,149,194,2018-06-07,partly-cloudy-night,nan
1720,860,860,2018-05-29,clear-day,nan
1,0,1,2018-03-19,clear-night,nan
1874,977,897,2018-05-29,clear-day,nan
1390,536,854,2018-04-17,partly-cloudy-day,Tax Day
870,395,475,2018-04-30,partly-cloudy-day,nan
1762,814,948,2018-06-07,cloudy,nan
1,0,1,2018-02-18,partly-cloudy-night,nan
785,364,421,2018-02-23,partly-cloudy-day,nan
346,228,118,2018-02-28,clear-night,nan
9,5,4,2018-04-03,clear-night,nan
131,94,37,2018-03-01,partly-cloudy-night,nan
1788,780,1008,2018-06-05,partly-cloudy-day,nan
1361,777,584,2018-04-24,clear-day,nan
162,99,63,2018-06-02,clear-night,nan
16,11,5,2018-03-30,partly-cloudy-night,nan
22,8,14,2018-03-02,rain,nan
2063,885,1178,2018-06-03,partly-cloudy-day,nan
61,59,2,2018-02-11,partly-cloudy-night,nan
268,147,121,2018-02-25,cloudy,nan
247,129,118,2018-06-10,cloudy,nan
205,171,34,2018-02-06,clear-night,nan
1869,905,964,2018-05-10,partly-cloudy-day,nan
374,197,177,2018-03-13,rain,nan
2324,1183,1141,2018-05-23,clear-day,nan
280,143,137,2018-03-12,partly-cloudy-night,nan
1543,767,776,2018-03-28,partly-cloudy-day,nan
185,106,79,2018-03-18,clear-day,nan
1083,619,464,2018-04-13,clear-day,nan
797,435,362,2018-06-04,cloudy,nan
1061,473,588,2018-06-04,partly-cloudy-day,nan
511,230,281,2018-04-26,clear-night,nan
1283,634,649,2018-05-17,partly-cloudy-day,nan
48,29,19,2018-03-12,clear-night,nan
23,13,10,2018-05-31,partly-cloudy-night,nan
109,65,44,2018-04-05,clear-night,nan
137,46,91,2018-04-29,clear-night,nan
458,172,286,2018-06-06,cloudy,nan
964,520,444,2018-02-15,partly-cloudy-day,nan
1320,751,569,2018-02-24,clear-day,nan
1173,626,547,2018-02-14,partly-cloudy-day,Valentine's Day
2689,1119,1570,2018-04-22,clear-day,nan
1975,982,993,2018-05-18,partly-cloudy-day,nan
2,1,1,2018-03-03,partly-cloudy-night,nan
1976,904,1072,2018-05-25,clear-day,nan
58,32,26,2018-04-25,cloudy,nan
374,185,189,2018-03-31,clear-night,nan
2964,1064,1900,2018-04-14,clear-day,nan
75,53,22,2018-02-23,rain,nan
6,1,5,2018-05-14,cloudy,nan
2,1,1,2018-03-22,partly-cloudy-night,nan
48,28,20,2018-05-19,rain,nan
20,16,4,2018-05-03,clear-night,nan
480,233,247,2018-04-06,partly-cloudy-night,nan
177,81,96,2018-05-01,partly-cloudy-night,nan
4,1,3,2018-02-09,partly-cloudy-night,nan
2099,1167,932,2018-06-02,clear-day,nan
10,7,3,2018-03-26,clear-night,nan
80,38,42,2018-04-27,partly-cloudy-night,nan
4,3,1,2018-02-20,cloudy,nan
20,10,10,2018-02-28,clear-night,nan
328,179,149,2018-03-15,partly-cloudy-night,nan
10,7,3,2018-04-16,rain,nan
1177,554,623,2018-02-27,clear-day,nan
183,85,98,2018-06-05,clear-day,nan
910,585,325,2018-05-28,partly-cloudy-day,Memorial Day
867,461,406,2018-04-10,partly-cloudy-day,nan
1104,553,551,2018-02-08,partly-cloudy-day,nan
138,65,73,2018-04-27,cloudy,nan
7,5,2,2018-02-25,partly-cloudy-night,nan
1112,481,631,2018-02-13,clear-day,nan
1745,854,891,2018-06-04,partly-cloudy-day,nan
757,246,511,2018-06-02,partly-cloudy-night,nan
9,4,5,2018-03-05,partly-cloudy-night,nan
2410,980,1430,2018-04-21,clear-day,nan
572,292,280,2018-06-08,clear-day,nan
50,39,11,2018-03-25,clear-night,nan
1884,879,1005,2018-05-02,clear-day,nan
8,5,3,2018-04-01,clear-night,Easter Sunday
1984,1119,865,2018-04-22,clear-day,nan
501,289,212,2018-04-25,cloudy,nan
60,31,29,2018-05-12,partly-cloudy-day,nan
1738,911,827,2018-03-17,clear-day,St. Patrick's Day
398,189,209,2018-04-22,clear-night,nan
1275,681,594,2018-03-05,cloudy,nan
1152,570,582,2018-03-14,partly-cloudy-day,nan
132,75,57,2018-02-26,clear-night,nan
2035,1068,967,2018-05-07,partly-cloudy-day,nan
106,53,53,2018-03-01,clear-night,nan
496,282,214,2018-05-13,cloudy,Mother's Day
885,467,418,2018-02-25,cloudy,nan
133,73,60,2018-04-14,cloudy,nan
215,86,129,2018-04-04,clear-night,nan
534,194,340,2018-05-08,clear-day,nan
82,36,46,2018-04-09,clear-night,nan
1456,546,910,2018-05-24,clear-day,nan
85,57,28,2018-05-12,cloudy,nan
1089,544,545,2018-03-08,snow,nan
118,46,72,2018-04-20,partly-cloudy-night,nan
1431,679,752,2018-03-27,clear-day,nan
2,1,1,2018-03-14,partly-cloudy-night,nan
7,3,4,2018-05-08,clear-night,nan
2,0,2,2018-02-14,partly-cloudy-night,Valentine's Day
105,78,27,2018-03-23,partly-cloudy-night,nan
363,133,230,2018-05-30,cloudy,nan
493,204,289,2018-06-09,clear-night,nan
105,42,63,2018-04-06,partly-cloudy-day,nan
755,366,389,2018-05-19,cloudy,nan
297,153,144,2018-02-09,clear-day,nan
3,1,2,2018-05-07,clear-night,nan
2032,945,1087,2018-03-26,clear-day,nan
166,78,88,2018-05-03,partly-cloudy-night,nan
2,0,2,2018-03-19,clear-night,nan
28,13,15,2018-04-03,cloudy,nan
25,19,6,2018-05-12,partly-cloudy-night,nan
1838,896,942,2018-06-06,cloudy,nan
1064,510,554,2018-05-13,rain,Mother's Day
1385,654,731,2018-04-11,partly-cloudy-day,nan
904,486,418,2018-03-30,partly-cloudy-day,nan
354,177,177,2018-02-20,cloudy,nan
717,391,326,2018-06-12,clear-day,nan
9,3,6,2018-03-12,clear-night,nan
1375,649,726,2018-05-08,clear-day,nan
1770,885,885,2018-04-06,partly-cloudy-day,nan
4,2,2,2018-05-26,clear-night,nan
1052,497,555,2018-04-23,clear-day,nan
606,189,417,2018-05-02,clear-day,nan
2509,1184,1325,2018-05-26,clear-day,nan
1288,650,638,2018-05-31,cloudy,nan
184,69,115,2018-04-18,cloudy,nan
447,244,203,2018-06-01,rain,nan
308,172,136,2018-04-21,clear-day,nan
3,0,3,2018-03-09,partly-cloudy-night,nan
20,10,10,2018-06-06,partly-cloudy-night,nan
7,2,5,2018-03-23,clear-night,nan
2276,1155,1121,2018-06-11,clear-day,nan
78,46,32,2018-04-29,partly-cloudy-day,nan
12,9,3,2018-03-30,partly-cloudy-night,nan
158,80,78,2018-05-24,clear-night,nan
230,83,147,2018-04-12,partly-cloudy-day,nan
3756,1848,1908,2018-04-14,clear-day,nan
939,414,525,2018-05-17,clear-day,nan
153,63,90,2018-04-01,partly-cloudy-day,Easter Sunday
907,399,508,2018-03-01,clear-day,nan
75,34,41,2018-03-29,partly-cloudy-night,nan
4,1,3,2018-03-06,clear-night,nan
1081,444,637,2018-05-28,cloudy,Memorial Day
9,2,7,2018-03-17,clear-night,St. Patrick's Day
167,117,50,2018-03-10,partly-cloudy-night,nan
2591,1236,1355,2018-06-09,clear-day,nan
349,193,156,2018-04-03,fog,nan
3,0,3,2018-05-24,clear-night,nan
795,427,368,2018-04-17,partly-cloudy-day,Tax Day
0,0,0,2018-03-17,clear-night,St. Patrick's Day
1442,753,689,2018-02-26,clear-day,nan
338,155,183,2018-05-06,cloudy,nan
1594,860,734,2018-05-10,partly-cloudy-day,nan
2033,868,1165,2018-05-06,cloudy,nan
7,5,2,2018-05-11,partly-cloudy-night,nan
1634,669,965,2018-05-15,clear-day,nan
168,92,76,2018-02-18,clear-day,nan
2054,953,1101,2018-04-07,partly-cloudy-day,nan
167,60,107,2018-04-01,clear-night,Easter Sunday
363,187,176,2018-03-14,clear-day,nan
1747,903,844,2018-05-03,clear-day,nan
4,2,2,2018-03-08,clear-night,nan
50,15,35,2018-04-15,partly-cloudy-day,nan
3,2,1,2018-06-04,rain,nan
386,190,196,2018-04-14,clear-day,nan
76,23,53,2018-06-03,partly-cloudy-night,nan
2108,1128,980,2018-05-11,clear-day,nan
808,407,401,2018-02-06,partly-cloudy-day,nan
858,341,517,2018-05-09,clear-night,nan
52,14,38,2018-04-25,rain,nan
185,102,83,2018-05-05,clear-night,Cinco de Mayo
232,89,143,2018-05-16,partly-cloudy-day,nan
1126,545,581,2018-05-22,partly-cloudy-day,nan
964,408,556,2018-02-17,partly-cloudy-day,nan
38,11,27,2018-03-21,partly-cloudy-night,nan
2473,1016,1457,2018-05-21,clear-day,nan
3,2,1,2018-02-06,clear-night,nan
202,106,96,2018-04-08,clear-night,nan
1550,631,919,2018-04-07,partly-cloudy-day,nan
1216,528,688,2018-03-16,partly-cloudy-day,nan
66,29,37,2018-03-22,clear-night,nan
481,325,156,2018-02-15,clear-night,nan
392,216,176,2018-02-11,rain,nan
7,5,2,2018-03-04,partly-cloudy-night,nan
1242,539,703,2018-02-19,partly-cloudy-day,Presidents' Day (regional holiday)
2488,1035,1453,2018-06-02,partly-cloudy-day,nan
231,106,125,2018-02-21,cloudy,nan
14,10,4,2018-06-02,clear-night,nan
387,185,202,2018-04-13,clear-night,nan
391,284,107,2018-02-12,clear-night,nan
3149,1462,1687,2018-04-29,partly-cloudy-day,nan
1487,810,677,2018-04-18,clear-day,nan
128,28,100,2018-02-07,partly-cloudy-day,nan
1183,536,647,2018-04-30,partly-cloudy-day,nan
254,181,73,2018-02-09,clear-night,nan
488,285,203,2018-03-03,clear-day,nan
1284,591,693,2018-06-08,partly-cloudy-day,nan
226,98,128,2018-04-23,clear-day,nan
1250,580,670,2018-02-21,clear-night,nan
2094,1042,1052,2018-05-24,clear-day,nan
4,3,1,2018-02-12,partly-cloudy-night,nan
113,45,68,2018-05-17,rain,nan
93,84,9,2018-02-10,rain,nan
11,6,5,2018-06-10,partly-cloudy-night,nan
292,140,152,2018-03-28,partly-cloudy-night,nan
44,24,20,2018-05-31,partly-cloudy-night,nan
193,114,79,2018-04-21,clear-night,nan
1342,643,699,2018-04-09,partly-cloudy-day,nan
1264,680,584,2018-05-04,clear-day,nan
89,47,42,2018-03-07,partly-cloudy-day,nan
553,313,240,2018-02-22,partly-cloudy-day,nan
256,125,131,2018-03-09,clear-night,nan
1370,613,757,2018-03-09,partly-cloudy-day,nan
266,114,152,2018-05-21,clear-day,nan
511,277,234,2018-05-16,rain,nan
4,2,2,2018-02-06,clear-night,nan
1598,725,873,2018-03-18,clear-day,nan
21,11,10,2018-04-10,clear-night,nan
213,101,112,2018-06-07,partly-cloudy-day,nan
2956,1239,1717,2018-05-05,clear-day,Cinco de Mayo
229,95,134,2018-05-10,partly-cloudy-day,nan
125,99,26,2018-05-15,rain,nan
86,40,46,2018-05-18,clear-night,nan
2094,1004,1090,2018-06-07,partly-cloudy-day,nan
1835,615,1220,2018-04-29,partly-cloudy-day,nan
322,161,161,2018-02-05,partly-cloudy-day,nan
2039,959,1080,2018-04-23,clear-day,nan
4,1,3,2018-02-08,clear-night,nan
32,16,16,2018-03-19,clear-night,nan
153,133,20,2018-06-08,clear-night,nan
3,0,3,2018-04-08,clear-night,nan
46,27,19,2018-04-16,rain,nan
1907,1188,719,2018-05-02,clear-day,nan
641,335,306,2018-05-15,partly-cloudy-day,nan
6,4,2,2018-05-19,cloudy,nan
12,7,5,2018-06-01,fog,nan
1233,651,582,2018-02-28,clear-day,nan
1900,806,1094,2018-06-01,partly-cloudy-day,nan
8,4,4,2018-02-17,clear-night,nan
151,146,5,2018-02-10,clear-night,nan
169,83,86,2018-02-07,snow,nan
0,0,0,2018-03-15,partly-cloudy-night,nan
574,326,248,2018-02-20,clear-night,nan
325,232,93,2018-02-14,clear-night,Valentine's Day
149,64,85,2018-02-15,partly-cloudy-day,nan
648,261,387,2018-06-06,cloudy,nan
45,15,30,2018-05-16,partly-cloudy-night,nan
2,1,1,2018-05-01,partly-cloudy-night,nan
7,4,3,2018-02-23,cloudy,nan
157,64,93,2018-02-26,clear-day,nan
997,679,318,2018-05-26,clear-day,nan
4,1,3,2018-04-20,clear-night,nan
1221,579,642,2018-02-13,clear-day,nan
200,130,70,2018-03-04,partly-cloudy-night,nan
126,67,59,2018-03-30,clear-night,nan
2498,1132,1366,2018-05-18,partly-cloudy-day,nan
6,5,1,2018-04-06,clear-night,nan
1153,654,499,2018-03-15,partly-cloudy-day,nan
3,3,0,2018-05-13,cloudy,Mother's Day
4210,2062,2148,2018-03-31,clear-day,nan
2244,1045,1199,2018-05-07,clear-day,nan
628,329,299,2018-05-23,partly-cloudy-day,nan
2,0,2,2018-05-02,clear-night,nan
2,0,2,2018-04-17,partly-cloudy-night,Tax Day
1899,1015,884,2018-03-26,clear-day,nan
19,7,12,2018-03-21,snow,nan
99,90,9,2018-02-24,partly-cloudy-night,nan
1946,965,981,2018-05-14,cloudy,nan
14,6,8,2018-05-06,partly-cloudy-night,nan
1978,962,1016,2018-05-27,cloudy,nan
40,17,23,2018-05-07,partly-cloudy-night,nan
1941,830,1111,2018-03-27,clear-day,nan
107,85,22,2018-04-13,clear-night,nan
151,89,62,2018-03-08,partly-cloudy-night,nan
252,115,137,2018-02-16,partly-cloudy-day,nan
39,18,21,2018-02-21,partly-cloudy-night,nan
6,0,6,2018-04-09,clear-night,nan
1202,444,758,2018-03-14,clear-day,nan
19,11,8,2018-04-15,cloudy,nan
143,61,82,2018-06-05,clear-night,nan
857,512,345,2018-05-04,partly-cloudy-day,nan
506,180,326,2018-05-03,clear-day,nan
1712,793,919,2018-03-11,clear-day,Daylight Saving Time starts
1208,556,652,2018-03-05,partly-cloudy-day,nan
90,46,44,2018-05-08,clear-night,nan
1624,781,843,2018-02-19,clear-day,Presidents' Day (regional holiday)
39,27,12,2018-04-24,partly-cloudy-night,nan
2797,1251,1546,2018-05-11,clear-day,nan
188,96,92,2018-04-30,partly-cloudy-night,nan
3989,2185,1804,2018-03-31,clear-day,nan
1467,753,714,2018-05-12,partly-cloudy-day,nan
14,8,6,2018-05-30,clear-night,nan
82,52,30,2018-02-27,clear-night,nan
77,50,27,2018-05-19,cloudy,nan
11,4,7,2018-04-06,partly-cloudy-night,nan
3,2,1,2018-04-06,clear-night,nan
1670,853,817,2018-06-06,partly-cloudy-day,nan
490,201,289,2018-05-25,clear-day,nan
6,5,1,2018-04-29,partly-cloudy-night,nan
549,286,263,2018-05-31,cloudy,nan
448,235,213,2018-02-27,clear-day,nan
2,0,2,2018-04-30,clear-night,nan
987,423,564,2018-02-08,clear-day,nan
717,305,412,2018-03-20,partly-cloudy-day,nan
190,129,61,2018-03-06,partly-cloudy-night,nan
27,8,19,2018-02-13,partly-cloudy-night,nan
1057,667,390,2018-03-25,partly-cloudy-day,nan
236,107,129,2018-04-13,clear-day,nan
89,62,27,2018-05-16,cloudy,nan
952,351,601,2018-03-10,clear-day,nan
22,14,8,2018-02-17,clear-night,nan
1517,679,838,2018-03-23,clear-day,nan
462,230,232,2018-04-25,rain,nan
2414,1150,1264,2018-04-29,partly-cloudy-day,nan
219,111,108,2018-05-05,clear-day,Cinco de Mayo
12,3,9,2018-06-07,cloudy,nan
2223,1008,1215,2018-05-04,partly-cloudy-day,nan
1752,848,904,2018-05-08,clear-day,nan
7,3,4,2018-05-10,cloudy,nan
72,56,16,2018-03-24,clear-night,nan
68,33,35,2018-02-11,rain,nan
109,49,60,2018-05-14,partly-cloudy-night,nan
2145,924,1221,2018-02-17,clear-day,nan
2,1,1,2018-04-02,partly-cloudy-night,nan
1834,836,998,2018-03-18,clear-day,nan
516,201,315,2018-05-11,clear-day,nan
16,9,7,2018-03-02,partly-cloudy-night,nan
2822,1736,1086,2018-04-14,clear-day,nan
1722,765,957,2018-05-03,clear-day,nan
385,213,172,2018-03-08,clear-day,nan
2,1,1,2018-04-09,clear-night,nan
91,78,13,2018-04-19,clear-night,nan
353,179,174,2018-05-11,partly-cloudy-night,nan
360,117,243,2018-05-20,clear-night,nan
1081,567,514,2018-05-27,cloudy,nan
692,319,373,2018-02-23,cloudy,nan
3,0,3,2018-02-18,partly-cloudy-night,nan
73,31,42,2018-04-17,partly-cloudy-night,Tax Day
445,222,223,2018-03-30,partly-cloudy-day,nan
619,322,297,2018-04-11,partly-cloudy-day,nan
1253,595,658,2018-04-27,partly-cloudy-day,nan
997,565,432,2018-05-15,clear-day,nan
5,4,1,2018-04-15,rain,nan
1006,401,605,2018-05-05,clear-night,Cinco de Mayo
2433,1187,1246,2018-05-21,clear-day,nan
46,19,27,2018-05-10,partly-cloudy-night,nan
10,5,5,2018-02-23,cloudy,nan
969,368,601,2018-03-11,clear-day,Daylight Saving Time starts
11,6,5,2018-02-22,cloudy,nan
780,374,406,2018-02-06,partly-cloudy-day,nan
147,72,75,2018-03-17,clear-day,St. Patrick's Day
546,276,270,2018-06-09,clear-day,nan
386,170,216,2018-05-29,cloudy,nan
1496,697,799,2018-03-16,partly-cloudy-day,nan
1030,510,520,2018-03-22,clear-day,nan
11,6,5,2018-02-12,partly-cloudy-night,nan
275,157,118,2018-03-11,clear-night,Daylight Saving Time starts
82,73,9,2018-02-15,partly-cloudy-night,nan
1159,501,658,2018-05-23,clear-day,nan
2,0,2,2018-02-11,rain,nan
48,28,20,2018-03-28,partly-cloudy-night,nan
13,8,5,2018-05-09,clear-night,nan
128,58,70,2018-02-06,partly-cloudy-night,nan
828,386,442,2018-04-10,partly-cloudy-day,nan
0,0,0,2018-04-04,fog,nan
1,0,1,2018-02-07,clear-night,nan
1913,1096,817,2018-04-13,clear-day,nan
5,3,2,2018-03-11,partly-cloudy-night,Daylight Saving Time starts
3,1,2,2018-05-21,clear-night,nan
944,590,354,2018-04-12,clear-day,nan
544,238,306,2018-04-03,rain,nan
2006,835,1171,2018-05-24,clear-day,nan
59,27,32,2018-06-08,partly-cloudy-night,nan
164,113,51,2018-02-21,cloudy,nan
37,23,14,2018-04-24,clear-night,nan
413,189,224,2018-06-02,clear-day,nan
33,11,22,2018-05-30,clear-night,nan
1535,687,848,2018-03-12,partly-cloudy-day,nan
33,9,24,2018-02-12,clear-night,nan
2636,1029,1607,2018-04-29,partly-cloudy-day,nan
366,212,154,2018-03-31,clear-day,nan
1972,703,1269,2018-04-28,clear-day,nan
1688,800,888,2018-04-09,clear-day,nan
1729,857,872,2018-02-12,clear-day,nan
74,34,40,2018-02-05,clear-night,nan
229,107,122,2018-03-24,partly-cloudy-night,nan
199,63,136,2018-04-15,cloudy,nan
440,214,226,2018-02-22,partly-cloudy-day,nan
25,5,20,2018-03-29,cloudy,nan
36,26,10,2018-03-09,clear-night,nan
2180,1028,1152,2018-05-01,clear-day,nan
0,0,0,2018-03-13,partly-cloudy-night,nan
53,29,24,2018-04-19,rain,nan
464,260,204,2018-02-16,clear-day,nan
485,257,228,2018-05-31,partly-cloudy-day,nan
0,0,0,2018-03-13,partly-cloudy-night,nan
2092,898,1194,2018-04-07,partly-cloudy-day,nan
1661,746,915,2018-02-20,clear-day,nan
0,0,0,2018-03-02,rain,nan
46,29,17,2018-03-07,sleet,nan
1089,551,538,2018-02-28,clear-day,nan
982,324,658,2018-05-25,clear-night,nan
1897,737,1160,2018-06-10,cloudy,nan
300,190,110,2018-02-17,partly-cloudy-night,nan
200,103,97,2018-04-05,clear-night,nan
1797,845,952,2018-04-23,clear-day,nan
349,256,93,2018-02-13,clear-night,nan
1937,899,1038,2018-05-30,clear-day,nan
1855,933,922,2018-06-01,clear-day,nan
2526,1417,1109,2018-02-18,rain,nan
1010,489,521,2018-02-09,clear-day,nan
81,79,2,2018-02-15,partly-cloudy-night,nan
4,3,1,2018-02-15,partly-cloudy-night,nan
2,0,2,2018-02-05,clear-night,nan
111,47,64,2018-02-17,clear-day,nan
1968,1102,866,2018-05-07,partly-cloudy-day,nan
105,47,58,2018-02-10,partly-cloudy-night,nan
130,70,60,2018-03-15,clear-night,nan
1143,636,507,2018-03-10,clear-day,nan
82,65,17,2018-04-28,rain,nan
576,268,308,2018-02-10,partly-cloudy-day,nan
418,188,230,2018-04-02,clear-night,nan
1826,696,1130,2018-03-31,clear-day,nan
48,30,18,2018-02-19,clear-night,Presidents' Day (regional holiday)
3028,1207,1821,2018-04-21,clear-day,nan
164,91,73,2018-04-08,clear-day,nan
11,9,2,2018-04-15,cloudy,nan
92,43,49,2018-05-13,partly-cloudy-day,Mother's Day
7,1,6,2018-05-07,partly-cloudy-night,nan
4,3,1,2018-02-26,partly-cloudy-night,nan
14,6,8,2018-02-16,partly-cloudy-night,nan
53,39,14,2018-02-19,fog,Presidents' Day (regional holiday)
181,65,116,2018-02-08,clear-day,nan
1852,844,1008,2018-03-10,cloudy,nan
2,0,2,2018-02-13,clear-night,nan
1677,830,847,2018-05-30,cloudy,nan
69,30,39,2018-02-23,partly-cloudy-night,nan
3092,1499,1593,2018-04-01,partly-cloudy-day,Easter Sunday
644,338,306,2018-04-16,rain,nan
359,163,196,2018-05-02,clear-day,nan
13,9,4,2018-05-23,rain,nan
4,3,1,2018-04-11,clear-night,nan
2970,1301,1669,2018-05-28,cloudy,Memorial Day
284,142,142,2018-03-25,partly-cloudy-night,nan
785,404,381,2018-03-14,clear-day,nan
241,143,98,2018-02-24,cloudy,nan
1029,486,543,2018-04-04,clear-day,nan
11,5,6,2018-03-09,partly-cloudy-night,nan
357,237,120,2018-05-16,rain,nan
10,8,2,2018-03-21,cloudy,nan
2310,1045,1265,2018-04-20,clear-day,nan
1439,628,811,2018-03-04,partly-cloudy-day,nan
2397,1104,1293,2018-05-14,partly-cloudy-day,nan
10,6,4,2018-03-20,clear-night,nan
1318,720,598,2018-06-08,clear-day,nan
911,400,511,2018-03-30,partly-cloudy-day,nan
178,70,108,2018-04-17,partly-cloudy-day,Tax Day
2131,1090,1041,2018-02-21,clear-day,nan
120,53,67,2018-03-26,clear-night,nan
1177,639,538,2018-06-06,cloudy,nan
7,2,5,2018-05-03,clear-night,nan
38,24,14,2018-05-16,cloudy,nan
8,4,4,2018-05-29,partly-cloudy-night,nan
474,204,270,2018-04-24,partly-cloudy-night,nan
240,98,142,2018-06-11,partly-cloudy-day,nan
2073,1065,1008,2018-03-11,clear-day,Daylight Saving Time starts
2156,1035,1121,2018-05-08,clear-day,nan
18,13,5,2018-03-17,clear-night,St. Patrick's Day
1665,786,879,2018-03-03,clear-day,nan
1973,906,1067,2018-06-01,partly-cloudy-day,nan
985,571,414,2018-04-07,partly-cloudy-day,nan
11,6,5,2018-05-25,clear-night,nan
28,16,12,2018-02-27,clear-night,nan
77,42,35,2018-03-21,snow,nan
8,4,4,2018-05-01,partly-cloudy-night,nan
3,2,1,2018-03-06,clear-night,nan
3,1,2,2018-03-07,partly-cloudy-night,nan
805,397,408,2018-05-13,cloudy,Mother's Day
24,14,10,2018-05-27,rain,nan
1931,889,1042,2018-03-25,partly-cloudy-day,nan
235,95,140,2018-06-11,clear-night,nan
267,125,142,2018-03-16,clear-night,nan
92,42,50,2018-04-30,partly-cloudy-night,nan
3,3,0,2018-04-02,cloudy,nan
63,37,26,2018-05-02,clear-night,nan
5,3,2,2018-04-13,clear-night,nan
19,14,5,2018-02-08,clear-night,nan
3020,1528,1492,2018-05-26,clear-day,nan
50,30,20,2018-06-01,cloudy,nan
4,4,0,2018-03-10,clear-night,nan
170,118,52,2018-02-16,clear-night,nan
41,14,27,2018-03-13,partly-cloudy-night,nan
2049,1025,1024,2018-04-18,clear-day,nan
142,73,69,2018-05-22,clear-day,nan
1445,691,754,2018-03-15,partly-cloudy-day,nan
192,60,132,2018-02-22,partly-cloudy-day,nan
1163,463,700,2018-03-22,clear-day,nan
2035,995,1040,2018-04-26,clear-day,nan
1559,745,814,2018-02-21,clear-day,nan
8,2,6,2018-03-03,partly-cloudy-night,nan
6,5,1,2018-05-14,cloudy,nan
35,11,24,2018-03-12,clear-night,nan
105,54,51,2018-03-07,partly-cloudy-day,nan
8,7,1,2018-03-07,sleet,nan
1682,824,858,2018-03-28,partly-cloudy-day,nan
116,49,67,2018-05-20,partly-cloudy-day,nan
1324,787,537,2018-05-09,clear-day,nan
3,0,3,2018-03-18,clear-night,nan
2050,893,1157,2018-05-04,clear-day,nan
149,86,63,2018-05-06,partly-cloudy-night,nan
12,10,2,2018-06-02,clear-night,nan
97,57,40,2018-04-02,snow,nan
1233,542,691,2018-05-29,clear-day,nan
648,345,303,2018-02-24,clear-day,nan
82,40,42,2018-04-22,clear-night,nan
2157,1336,821,2018-04-28,partly-cloudy-day,nan
148,61,87,2018-02-18,clear-night,nan
12,7,5,2018-03-24,partly-cloudy-night,nan
5,4,1,2018-06-11,partly-cloudy-night,nan
6,4,2,2018-04-22,clear-night,nan
1801,775,1026,2018-03-29,cloudy,nan
2075,1028,1047,2018-06-08,partly-cloudy-day,nan
55,23,32,2018-05-17,rain,nan
207,147,60,2018-03-29,fog,nan
35,22,13,2018-03-01,partly-cloudy-night,nan
22,16,6,2018-03-25,clear-night,nan
213,169,44,2018-02-22,partly-cloudy-night,nan
1425,868,557,2018-06-12,clear-day,nan
975,413,562,2018-06-01,clear-day,nan
155,75,80,2018-04-09,partly-cloudy-night,nan
163,73,90,2018-03-12,partly-cloudy-night,nan
2491,1026,1465,2018-06-03,partly-cloudy-day,nan
752,373,379,2018-05-24,clear-day,nan
1350,784,566,2018-06-05,partly-cloudy-day,nan
341,225,116,2018-04-03,fog,nan
574,324,250,2018-05-19,rain,nan
1,0,1,2018-04-10,partly-cloudy-night,nan
23,16,7,2018-03-01,partly-cloudy-night,nan
1211,485,726,2018-04-03,partly-cloudy-day,nan
113,91,22,2018-04-11,partly-cloudy-night,nan
1273,722,551,2018-05-10,partly-cloudy-day,nan
1262,545,717,2018-03-19,clear-day,nan
9,8,1,2018-02-27,clear-night,nan
801,374,427,2018-05-18,cloudy,nan
943,541,402,2018-04-28,partly-cloudy-day,nan
120,52,68,2018-03-03,partly-cloudy-night,nan
1078,502,576,2018-04-10,partly-cloudy-day,nan
1208,572,636,2018-04-02,partly-cloudy-day,nan
6,3,3,2018-02-24,partly-cloudy-night,nan
2190,1082,1108,2018-05-23,clear-day,nan
173,117,56,2018-03-14,partly-cloudy-night,nan
381,235,146,2018-03-18,clear-day,nan
1858,760,1098,2018-04-08,partly-cloudy-day,nan
4,2,2,2018-04-26,partly-cloudy-night,nan
1,0,1,2018-03-07,partly-cloudy-night,nan
446,182,264,2018-06-10,partly-cloudy-night,nan
146,77,69,2018-03-11,clear-night,Daylight Saving Time starts
2796,1286,1510,2018-05-20,partly-cloudy-day,nan
1317,659,658,2018-02-10,partly-cloudy-day,nan
10,5,5,2018-02-07,clear-night,nan
1010,533,477,2018-02-05,clear-day,nan
172,85,87,2018-04-26,partly-cloudy-night,nan
109,85,24,2018-02-11,partly-cloudy-night,nan
339,191,148,2018-02-13,clear-day,nan
1296,473,823,2018-05-21,clear-day,nan
1062,550,512,2018-03-12,clear-day,nan
859,491,368,2018-04-17,partly-cloudy-day,Tax Day
11,8,3,2018-02-07,partly-cloudy-night,nan
1466,661,805,2018-04-12,clear-day,nan
124,45,79,2018-05-28,cloudy,Memorial Day
367,179,188,2018-06-04,cloudy,nan
68,24,44,2018-03-17,clear-night,St. Patrick's Day
73,40,33,2018-02-07,rain,nan
711,387,324,2018-04-24,clear-day,nan
2552,1048,1504,2018-04-05,partly-cloudy-day,nan
223,110,113,2018-03-18,clear-night,nan
1367,721,646,2018-02-12,partly-cloudy-day,nan
7,3,4,2018-03-31,partly-cloudy-night,nan
1161,516,645,2018-02-16,clear-day,nan
34,10,24,2018-04-25,rain,nan
181,72,109,2018-03-05,clear-night,nan
321,172,149,2018-05-19,rain,nan
1840,829,1011,2018-04-24,clear-day,nan
3178,1669,1509,2018-05-28,partly-cloudy-day,Memorial Day
650,334,316,2018-02-23,partly-cloudy-day,nan
70,25,45,2018-03-13,snow,nan
1204,440,764,2018-04-08,partly-cloudy-day,nan
220,82,138,2018-04-04,fog,nan
1820,884,936,2018-05-10,partly-cloudy-day,nan
2252,959,1293,2018-04-13,clear-day,nan
1389,617,772,2018-03-23,partly-cloudy-day,nan
60,30,30,2018-02-25,cloudy,nan
515,170,345,2018-05-14,clear-night,nan
849,494,355,2018-02-20,cloudy,nan
41,16,25,2018-03-02,rain,nan
24,16,8,2018-05-05,partly-cloudy-night,Cinco de Mayo
283,216,67,2018-02-08,partly-cloudy-night,nan
1032,455,577,2018-02-09,partly-cloudy-day,nan
2088,1034,1054,2018-06-10,partly-cloudy-day,nan
2775,1456,1319,2018-04-01,clear-day,Easter Sunday
1256,555,701,2018-02-15,clear-day,nan
1063,487,576,2018-02-14,partly-cloudy-day,Valentine's Day
192,154,38,2018-04-12,clear-night,nan
1336,606,730,2018-05-30,clear-day,nan
1618,872,746,2018-02-18,clear-day,nan
17,10,7,2018-02-25,rain,nan
63,38,25,2018-05-27,rain,nan
48,20,28,2018-06-05,clear-night,nan
82,33,49,2018-05-26,clear-night,nan
1854,883,971,2018-03-10,partly-cloudy-day,nan
10,6,4,2018-04-01,clear-night,Easter Sunday
12,3,9,2018-02-19,clear-night,Presidents' Day (regional holiday)
10,8,2,2018-02-10,partly-cloudy-night,nan
817,350,467,2018-05-12,cloudy,nan
267,158,109,2018-04-14,cloudy,nan
1977,865,1112,2018-02-24,partly-cloudy-day,nan
30,16,14,2018-04-27,clear-night,nan
21,11,10,2018-04-03,clear-night,nan
16,9,7,2018-03-16,clear-night,nan
565,300,265,2018-04-27,partly-cloudy-day,nan
327,167,160,2018-05-22,partly-cloudy-day,nan
7,3,4,2018-06-05,clear-night,nan
128,65,63,2018-02-19,partly-cloudy-night,Presidents' Day (regional holiday)
1036,509,527,2018-02-08,clear-day,nan
40,27,13,2018-03-16,clear-night,nan
6,0,6,2018-04-27,clear-night,nan
1,0,1,2018-03-19,clear-night,nan
1382,617,765,2018-03-15,clear-day,nan
92,36,56,2018-05-07,clear-night,nan
1060,561,499,2018-04-18,partly-cloudy-day,nan
0,0,0,2018-04-16,rain,nan
514,156,358,2018-06-05,clear-day,nan
537,276,261,2018-03-26,clear-day,nan
1747,875,872,2018-05-02,clear-day,nan
11,5,6,2018-02-17,snow,nan
6,4,2,2018-05-28,cloudy,Memorial Day
79,34,45,2018-04-07,partly-cloudy-night,nan
1363,670,693,2018-03-04,partly-cloudy-day,nan
345,166,179,2018-06-09,clear-night,nan
97,49,48,2018-04-11,clear-night,nan
1485,680,805,2018-02-27,clear-day,nan
3,0,3,2018-04-30,partly-cloudy-night,nan
1297,726,571,2018-06-04,partly-cloudy-day,nan
51,23,28,2018-06-03,rain,nan
1582,755,827,2018-05-17,partly-cloudy-day,nan
5,4,1,2018-04-23,clear-night,nan
1066,424,642,2018-05-01,clear-night,nan
16,11,5,2018-02-14,partly-cloudy-night,Valentine's Day
1910,816,1094,2018-05-17,partly-cloudy-day,nan
334,140,194,2018-05-09,clear-day,nan
12,10,2,2018-04-08,clear-night,nan
62,35,27,2018-03-20,clear-night,nan
2113,1123,990,2018-05-11,clear-day,nan
229,94,135,2018-03-09,partly-cloudy-day,nan
415,207,208,2018-02-28,clear-day,nan
3,2,1,2018-04-05,clear-night,nan
1852,844,1008,2018-03-03,partly-cloudy-day,nan
71,37,34,2018-05-25,clear-night,nan
743,456,287,2018-04-19,rain,nan
75,51,24,2018-04-25,fog,nan
1049,463,586,2018-03-08,partly-cloudy-day,nan
11,7,4,2018-03-05,partly-cloudy-night,nan
133,66,67,2018-05-18,partly-cloudy-day,nan
67,38,29,2018-06-12,clear-night,nan
1660,698,962,2018-05-06,partly-cloudy-day,nan
11,9,2,2018-06-03,partly-cloudy-night,nan
14,6,8,2018-05-14,cloudy,nan
421,204,217,2018-02-25,rain,nan
193,86,107,2018-03-22,partly-cloudy-day,nan
2434,1104,1330,2018-06-09,clear-day,nan
466,180,286,2018-05-07,clear-day,nan
22,10,12,2018-03-27,clear-night,nan
342,226,116,2018-04-06,partly-cloudy-day,nan
3106,1511,1595,2018-04-21,clear-day,nan
1326,543,783,2018-05-03,clear-day,nan
139,59,80,2018-02-14,partly-cloudy-day,Valentine's Day
47,22,25,2018-05-03,clear-night,nan
832,431,401,2018-03-01,clear-day,nan
15,10,5,2018-04-07,cloudy,nan
70,32,38,2018-06-12,clear-night,nan
169,74,95,2018-05-18,cloudy,nan
751,378,373,2018-02-25,cloudy,nan
43,30,13,2018-02-23,cloudy,nan
167,109,58,2018-03-21,snow,nan
26,17,9,2018-02-20,cloudy,nan
1482,620,862,2018-03-06,clear-day,nan
1079,609,470,2018-02-14,partly-cloudy-day,Valentine's Day
719,419,300,2018-04-25,cloudy,nan
58,35,23,2018-06-09,clear-night,nan
1937,907,1030,2018-06-11,clear-day,nan
444,207,237,2018-03-13,partly-cloudy-night,nan
1298,533,765,2018-05-06,partly-cloudy-day,nan
17,10,7,2018-02-09,clear-night,nan
2619,1225,1394,2018-05-26,clear-day,nan
132,54,78,2018-03-19,clear-night,nan
10,9,1,2018-04-05,clear-night,nan
60,27,33,2018-04-23,clear-night,nan
1859,795,1064,2018-03-17,clear-day,St. Patrick's Day
858,363,495,2018-05-31,cloudy,nan
576,311,265,2018-07-09,clear-day,nan
2181,1117,1064,2018-07-19,clear-day,nan
664,335,329,2018-06-15,partly-cloudy-day,nan
1774,846,928,2018-07-25,partly-cloudy-day,nan
68,45,23,2018-07-16,clear-night,nan
2346,1113,1233,2018-07-08,clear-day,nan
11,10,1,2018-07-25,partly-cloudy-night,nan
1859,949,910,2018-06-27,cloudy,nan
134,70,64,2018-06-18,clear-day,nan
9,7,2,2018-07-31,partly-cloudy-night,nan
21,14,7,2018-07-14,clear-night,nan
2414,1125,1289,2018-06-16,clear-day,nan
1317,643,674,2018-07-02,clear-day,nan
3173,1458,1715,2018-07-28,partly-cloudy-day,nan
192,111,81,2018-06-26,clear-night,nan
343,245,98,2018-07-17,rain,nan
667,352,315,2018-07-20,clear-day,nan
523,219,304,2018-06-26,clear-day,nan
2597,1099,1498,2018-07-08,clear-day,nan
1226,629,597,2018-07-25,cloudy,nan
633,220,413,2018-06-22,partly-cloudy-night,nan
2257,1240,1017,2018-07-19,clear-day,nan
51,26,25,2018-07-04,clear-night,Independence Day
2211,969,1242,2018-07-27,rain,nan
2955,1258,1697,2018-07-22,partly-cloudy-day,nan
124,59,65,2018-07-02,clear-night,nan
146,71,75,2018-06-22,partly-cloudy-day,nan
2746,1210,1536,2018-07-21,partly-cloudy-day,nan
1807,857,950,2018-06-12,clear-day,nan
2222,1074,1148,2018-07-31,partly-cloudy-day,nan
1430,526,904,2018-07-14,clear-night,nan
2074,973,1101,2018-07-05,partly-cloudy-day,nan
213,88,125,2018-07-10,clear-day,nan
13,11,2,2018-06-16,clear-night,nan
2546,1274,1272,2018-07-28,partly-cloudy-day,nan
1526,684,842,2018-07-02,clear-day,nan
8,6,2,2018-06-27,partly-cloudy-night,nan
1744,811,933,2018-06-29,partly-cloudy-day,nan
15,5,10,2018-07-23,rain,nan
1437,572,865,2018-06-19,clear-day,nan
227,124,103,2018-07-04,clear-day,Independence Day
2093,1107,986,2018-07-30,partly-cloudy-day,nan
1945,948,997,2018-07-06,clear-day,nan
142,57,85,2018-07-14,clear-day,nan
501,269,232,2018-07-24,partly-cloudy-day,nan
211,96,115,2018-06-17,clear-day,Father's Day
274,135,139,2018-07-10,clear-night,nan
611,326,285,2018-07-12,clear-night,nan
1824,778,1046,2018-06-21,clear-day,nan
176,105,71,2018-06-24,cloudy,nan
125,40,85,2018-07-27,clear-night,nan
355,163,192,2018-07-23,partly-cloudy-night,nan
494,183,311,2018-06-25,clear-day,nan
480,480,0,2018-07-13,clear-day,nan
64,48,16,2018-07-27,clear-night,nan
1975,1078,897,2018-06-12,clear-day,nan
1006,358,648,2018-07-18,clear-night,nan
50,31,19,2018-07-01,clear-night,nan
1848,945,903,2018-06-17,clear-day,Father's Day
1371,657,714,2018-06-22,partly-cloudy-day,nan
17,8,9,2018-07-30,clear-night,nan
33,14,19,2018-06-28,rain,nan
12,7,5,2018-07-19,clear-night,nan
2020,904,1116,2018-06-30,clear-day,nan
1638,923,715,2018-07-09,clear-day,nan
994,553,441,2018-07-03,partly-cloudy-day,nan
44,28,16,2018-07-08,clear-night,nan
2098,954,1144,2018-06-23,cloudy,nan
1481,788,693,2018-07-10,clear-day,nan
369,191,178,2018-06-20,cloudy,nan
866,539,327,2018-07-07,clear-day,nan
350,151,199,2018-07-25,cloudy,nan
763,435,328,2018-07-18,clear-day,nan
618,320,298,2018-07-31,partly-cloudy-day,nan
285,122,163,2018-06-12,clear-night,nan
1215,660,555,2018-07-27,clear-day,nan
1402,541,861,2018-06-28,partly-cloudy-day,nan
1151,545,606,2018-06-28,rain,nan
1211,534,677,2018-06-14,clear-day,nan
1120,401,719,2018-07-29,partly-cloudy-night,nan
2093,2093,0,2018-07-04,partly-cloudy-day,Independence Day
1341,734,607,2018-07-05,partly-cloudy-day,nan
888,487,401,2018-06-18,clear-day,nan
344,134,210,2018-07-03,clear-day,nan
109,50,59,2018-07-31,clear-night,nan
2074,960,1114,2018-07-15,clear-day,nan
263,111,152,2018-07-12,partly-cloudy-day,nan
8,6,2,2018-07-02,clear-night,nan
970,523,447,2018-07-16,clear-day,nan
1517,668,849,2018-07-11,partly-cloudy-day,nan
2188,2188,0,2018-07-13,partly-cloudy-day,nan
2312,1045,1267,2018-07-20,clear-day,nan
43,23,20,2018-07-21,cloudy,nan
1739,921,818,2018-07-26,clear-day,nan
1932,988,944,2018-06-26,clear-day,nan
991,991,0,2018-07-04,partly-cloudy-night,Independence Day
154,61,93,2018-06-18,rain,nan
148,67,81,2018-07-21,partly-cloudy-day,nan
859,467,392,2018-07-10,clear-day,nan
38,19,19,2018-07-17,clear-night,nan
1498,912,586,2018-06-19,clear-day,nan
32,8,24,2018-07-28,partly-cloudy-night,nan
422,163,259,2018-06-29,clear-day,nan
596,286,310,2018-07-19,clear-night,nan
76,43,33,2018-06-20,clear-night,nan
33,17,16,2018-07-24,partly-cloudy-night,nan
2412,1233,1179,2018-07-29,partly-cloudy-day,nan
177,86,91,2018-06-14,clear-day,nan
23,17,6,2018-07-15,rain,nan
44,20,24,2018-07-12,partly-cloudy-night,nan
1348,646,702,2018-07-17,partly-cloudy-day,nan
1081,368,713,2018-06-29,clear-night,nan
985,396,589,2018-06-13,partly-cloudy-day,nan
31,13,18,2018-07-23,cloudy,nan
668,365,303,2018-07-19,clear-day,nan
8,3,5,2018-07-26,partly-cloudy-night,nan
2222,1133,1089,2018-06-24,partly-cloudy-day,nan
31,20,11,2018-06-25,clear-night,nan
1299,580,719,2018-06-25,clear-day,nan
43,20,23,2018-07-06,clear-night,nan
2170,1018,1152,2018-06-30,clear-day,nan
31,18,13,2018-06-14,partly-cloudy-night,nan
744,348,396,2018-06-13,partly-cloudy-day,nan
1854,825,1029,2018-07-09,clear-day,nan
29,18,11,2018-06-23,cloudy,nan
1349,593,756,2018-06-28,rain,nan
1882,910,972,2018-06-14,clear-day,nan
1734,882,852,2018-07-26,partly-cloudy-day,nan
2042,1041,1001,2018-07-12,partly-cloudy-day,nan
19,6,13,2018-06-13,partly-cloudy-night,nan
39,17,22,2018-07-06,rain,nan
11,8,3,2018-06-20,clear-night,nan
1505,830,675,2018-07-12,partly-cloudy-day,nan
14,9,5,2018-07-15,rain,nan
90,58,32,2018-06-28,cloudy,nan
1473,663,810,2018-07-03,clear-day,nan
58,36,22,2018-06-17,clear-night,Father's Day
359,163,196,2018-07-06,clear-night,nan
160,73,87,2018-07-08,clear-day,nan
793,429,364,2018-07-17,partly-cloudy-day,nan
2440,1313,1127,2018-07-20,clear-day,nan
1888,1074,814,2018-07-11,partly-cloudy-day,nan
1213,1213,0,2018-07-13,clear-day,nan
539,182,357,2018-07-15,clear-night,nan
1862,911,951,2018-06-17,clear-day,Father's Day
1287,624,663,2018-06-26,partly-cloudy-day,nan
1819,1010,809,2018-07-21,partly-cloudy-day,nan
541,251,290,2018-06-27,partly-cloudy-day,nan
1594,748,846,2018-06-20,partly-cloudy-day,nan
2220,1034,1186,2018-07-26,partly-cloudy-day,nan
2948,1339,1609,2018-07-29,partly-cloudy-day,nan
5,4,1,2018-07-22,rain,nan
13,9,4,2018-07-05,partly-cloudy-night,nan
1683,823,860,2018-07-01,clear-day,nan
17,6,11,2018-06-19,partly-cloudy-night,nan
1768,723,1045,2018-07-16,clear-day,nan
30,14,16,2018-07-20,clear-night,nan
1957,1034,923,2018-07-05,clear-day,nan
22,13,9,2018-07-09,clear-night,nan
21,13,8,2018-07-18,partly-cloudy-night,nan
435,198,237,2018-07-27,rain,nan
578,351,227,2018-06-20,clear-day,nan
327,120,207,2018-06-13,cloudy,nan
198,82,116,2018-07-30,clear-day,nan
53,15,38,2018-06-30,clear-night,nan
2069,1100,969,2018-07-18,partly-cloudy-day,nan
1188,719,469,2018-06-14,clear-day,nan
232,92,140,2018-07-22,rain,nan
836,553,283,2018-06-16,clear-day,nan
2889,1324,1565,2018-07-07,clear-day,nan
2242,1129,1113,2018-07-24,partly-cloudy-day,nan
301,148,153,2018-06-24,cloudy,nan
2671,1299,1372,2018-07-14,clear-day,nan
72,48,24,2018-07-19,clear-night,nan
1516,731,785,2018-06-29,clear-day,nan
557,210,347,2018-07-28,clear-night,nan
25,10,15,2018-06-26,clear-night,nan
983,383,600,2018-06-18,partly-cloudy-day,nan
117,59,58,2018-06-22,partly-cloudy-night,nan
2265,1085,1180,2018-06-24,partly-cloudy-day,nan
17,13,4,2018-07-01,clear-night,nan
805,290,515,2018-06-14,clear-night,nan
1925,931,994,2018-06-25,partly-cloudy-day,nan
1189,1189,0,2018-06-15,partly-cloudy-day,nan
430,242,188,2018-07-28,partly-cloudy-day,nan
529,331,198,2018-06-23,cloudy,nan
1260,661,599,2018-06-13,partly-cloudy-day,nan
1427,720,707,2018-06-21,partly-cloudy-day,nan
235,117,118,2018-07-02,clear-day,nan
191,91,100,2018-07-21,partly-cloudy-night,nan
67,20,47,2018-07-03,clear-night,nan
379,120,259,2018-06-19,partly-cloudy-day,nan
178,81,97,2018-07-14,clear-night,nan
484,293,191,2018-07-15,partly-cloudy-day,nan
184,76,108,2018-06-19,clear-night,nan
7,3,4,2018-07-07,clear-night,nan
535,265,270,2018-06-30,clear-night,nan
560,276,284,2018-07-25,cloudy,nan
3272,1450,1822,2018-07-28,partly-cloudy-day,nan
865,280,585,2018-06-25,clear-night,nan
2,0,2,2018-06-28,rain,nan
2236,1215,1021,2018-07-08,clear-day,nan
131,57,74,2018-06-21,cloudy,nan
904,556,348,2018-07-09,clear-day,nan
22,12,10,2018-06-23,cloudy,nan
1589,808,781,2018-07-02,clear-day,nan
1775,649,1126,2018-07-29,partly-cloudy-day,nan
196,90,106,2018-07-17,clear-day,nan
665,254,411,2018-06-16,clear-night,nan
1278,719,559,2018-06-22,clear-day,nan
2037,918,1119,2018-06-17,clear-day,Father's Day
583,302,281,2018-07-03,clear-night,nan
1851,888,963,2018-07-30,partly-cloudy-day,nan
3240,1455,1785,2018-07-21,partly-cloudy-day,nan
96,39,57,2018-07-25,partly-cloudy-night,nan
86,36,50,2018-06-27,clear-night,nan
676,389,287,2018-07-06,cloudy,nan
15,9,6,2018-07-16,clear-night,nan
182,93,89,2018-06-16,clear-night,nan
73,48,25,2018-06-27,partly-cloudy-night,nan
912,433,479,2018-07-22,cloudy,nan
1913,1009,904,2018-07-31,partly-cloudy-day,nan
248,112,136,2018-07-26,partly-cloudy-day,nan
1787,928,859,2018-07-16,partly-cloudy-day,nan
67,39,28,2018-07-20,clear-night,nan
1414,689,725,2018-07-02,clear-day,nan
3518,1553,1965,2018-07-07,clear-day,nan
396,233,163,2018-07-23,cloudy,nan
1325,746,579,2018-07-14,clear-day,nan
1230,630,600,2018-06-18,partly-cloudy-day,nan
55,31,24,2018-07-31,partly-cloudy-night,nan
39,17,22,2018-06-29,clear-night,nan
8,5,3,2018-07-11,partly-cloudy-night,nan
34,18,16,2018-06-24,cloudy,nan
30,17,13,2018-06-15,clear-night,nan
660,295,365,2018-07-08,clear-night,nan
24,14,10,2018-07-19,clear-night,nan
433,148,285,2018-07-11,clear-day,nan
29,18,11,2018-07-13,clear-night,nan
1673,927,746,2018-06-21,clear-day,nan
2397,1061,1336,2018-06-24,partly-cloudy-day,nan
229,129,100,2018-07-22,cloudy,nan
2232,1056,1176,2018-07-18,clear-day,nan
8,5,3,2018-07-27,clear-night,nan
972,581,391,2018-07-01,partly-cloudy-day,nan
47,27,20,2018-07-29,clear-night,nan
141,77,64,2018-06-18,clear-night,nan
2304,1070,1234,2018-07-14,partly-cloudy-day,nan
93,45,48,2018-06-29,clear-night,nan
82,53,29,2018-06-16,clear-night,nan
35,10,25,2018-06-18,clear-night,nan
90,56,34,2018-07-10,clear-night,nan
15,7,8,2018-07-24,partly-cloudy-night,nan
1971,879,1092,2018-06-29,partly-cloudy-day,nan
2317,1115,1202,2018-07-23,partly-cloudy-day,nan
305,177,128,2018-06-17,clear-day,Father's Day
2135,1067,1068,2018-06-22,partly-cloudy-day,nan
451,270,181,2018-06-30,clear-day,nan
2003,961,1042,2018-06-12,clear-day,nan
3199,1552,1647,2018-07-28,partly-cloudy-day,nan
2112,965,1147,2018-06-23,cloudy,nan
292,144,148,2018-07-17,partly-cloudy-night,nan
1875,877,998,2018-07-03,partly-cloudy-day,nan
1679,845,834,2018-07-04,partly-cloudy-day,Independence Day
1825,788,1037,2018-06-25,partly-cloudy-day,nan
2136,1016,1120,2018-06-15,partly-cloudy-day,nan
8,4,4,2018-06-21,rain,nan
270,126,144,2018-06-25,clear-day,nan
174,67,107,2018-07-27,clear-day,nan
2555,1109,1446,2018-06-24,partly-cloudy-day,nan
73,37,36,2018-06-22,partly-cloudy-night,nan
445,260,185,2018-07-01,clear-day,nan
1835,1022,813,2018-06-12,clear-day,nan
1854,756,1098,2018-07-20,clear-day,nan
834,440,394,2018-06-22,partly-cloudy-day,nan
114,55,59,2018-06-15,clear-night,nan
54,21,33,2018-06-28,rain,nan
809,517,292,2018-06-17,clear-day,Father's Day
1116,539,577,2018-07-03,partly-cloudy-day,nan
2415,928,1487,2018-07-21,cloudy,nan
1935,959,976,2018-06-30,clear-day,nan
1551,990,561,2018-07-10,clear-day,nan
1680,772,908,2018-06-23,cloudy,nan
2260,1062,1198,2018-07-04,partly-cloudy-day,Independence Day
51,23,28,2018-07-10,clear-night,nan
113,50,63,2018-07-05,partly-cloudy-day,nan
2001,1001,1000,2018-07-15,cloudy,nan
59,19,40,2018-07-21,partly-cloudy-night,nan
84,50,34,2018-06-16,clear-night,nan
608,227,381,2018-06-20,partly-cloudy-night,nan
2143,1014,1129,2018-07-30,partly-cloudy-day,nan
72,59,13,2018-07-14,clear-night,nan
151,67,84,2018-07-16,clear-day,nan
175,80,95,2018-06-28,rain,nan
1620,823,797,2018-06-21,clear-day,nan
1531,789,742,2018-06-27,cloudy,nan
1516,1516,0,2018-07-04,partly-cloudy-day,Independence Day
2231,1056,1175,2018-06-16,partly-cloudy-day,nan
259,114,145,2018-07-26,clear-night,nan
178,87,91,2018-07-12,partly-cloudy-day,nan
18,12,6,2018-07-26,partly-cloudy-night,nan
2049,1053,996,2018-07-15,clear-day,nan
2267,1032,1235,2018-07-26,partly-cloudy-day,nan
219,92,127,2018-07-30,clear-night,nan
1011,589,422,2018-06-26,clear-day,nan
1268,781,487,2018-07-20,clear-day,nan
713,415,298,2018-07-22,cloudy,nan
2041,1146,895,2018-07-19,clear-day,nan
1800,1800,0,2018-07-13,clear-day,nan
157,87,70,2018-07-27,rain,nan
920,257,663,2018-07-16,partly-cloudy-night,nan
47,26,21,2018-07-25,partly-cloudy-night,nan
734,308,426,2018-07-14,clear-night,nan
234,97,137,2018-07-25,cloudy,nan
3,0,3,2018-07-22,rain,nan
3,1,2,2018-06-25,clear-night,nan
221,103,118,2018-06-23,cloudy,nan
230,90,140,2018-07-29,clear-day,nan
1383,753,630,2018-07-18,clear-day,nan
39,28,11,2018-06-27,clear-night,nan
1104,588,516,2018-07-31,clear-day,nan
1208,610,598,2018-06-13,cloudy,nan
65,48,17,2018-06-14,partly-cloudy-night,nan
1671,979,692,2018-07-07,clear-day,nan
5,1,4,2018-06-19,partly-cloudy-night,nan
1676,867,809,2018-07-16,clear-day,nan
979,311,668,2018-07-05,clear-night,nan
888,434,454,2018-06-28,partly-cloudy-day,nan
721,199,522,2018-06-24,partly-cloudy-night,nan
1148,714,434,2018-06-15,partly-cloudy-day,nan
11,5,6,2018-06-30,clear-night,nan
1347,608,739,2018-06-20,partly-cloudy-day,nan
1733,849,884,2018-06-29,clear-day,nan
600,334,266,2018-07-11,clear-day,nan
2437,1125,1312,2018-07-08,clear-day,nan
821,478,343,2018-06-30,clear-day,nan
304,170,134,2018-06-23,cloudy,nan
202,115,87,2018-07-15,rain,nan
485,272,213,2018-06-13,cloudy,nan
45,22,23,2018-06-18,clear-night,nan
520,269,251,2018-06-19,partly-cloudy-day,nan
1400,735,665,2018-07-16,clear-day,nan
884,403,481,2018-07-12,clear-night,nan
525,192,333,2018-06-13,partly-cloudy-night,nan
362,191,171,2018-06-16,clear-day,nan
2434,1184,1250,2018-07-20,clear-day,nan
285,89,196,2018-07-01,clear-night,nan
56,24,32,2018-06-22,partly-cloudy-night,nan
605,406,199,2018-07-17,partly-cloudy-day,nan
17,10,7,2018-07-06,partly-cloudy-night,nan
1521,791,730,2018-07-02,clear-day,nan
1049,515,534,2018-07-25,cloudy,nan
51,30,21,2018-06-23,rain,nan
1579,900,679,2018-06-20,partly-cloudy-day,nan
1616,753,863,2018-06-27,cloudy,nan
62,36,26,2018-06-15,clear-night,nan
2619,1184,1435,2018-07-08,clear-day,nan
9,7,2,2018-07-19,clear-night,nan
39,15,24,2018-07-18,partly-cloudy-night,nan
2395,942,1453,2018-06-30,clear-day,nan
2728,1366,1362,2018-06-16,clear-day,nan
73,45,28,2018-06-26,clear-night,nan
2148,930,1218,2018-07-31,partly-cloudy-day,nan
68,42,26,2018-07-10,clear-night,nan
1691,822,869,2018-07-06,clear-day,nan
129,59,70,2018-07-04,clear-day,Independence Day
19,5,14,2018-07-17,clear-night,nan
2133,858,1275,2018-07-19,clear-day,nan
1653,795,858,2018-07-30,partly-cloudy-day,nan
1495,662,833,2018-07-01,clear-day,nan
23,12,11,2018-07-03,clear-night,nan
1595,854,741,2018-07-27,partly-cloudy-day,nan
53,29,24,2018-07-25,rain,nan
92,44,48,2018-07-14,clear-night,nan
442,244,198,2018-07-10,partly-cloudy-night,nan
1729,926,803,2018-07-05,partly-cloudy-day,nan
2524,1197,1327,2018-07-29,partly-cloudy-day,nan
14,8,6,2018-07-12,partly-cloudy-night,nan
1154,676,478,2018-07-01,clear-day,nan
1173,372,801,2018-07-17,partly-cloudy-day,nan
75,32,43,2018-06-26,clear-night,nan
11,3,8,2018-07-23,cloudy,nan
2192,954,1238,2018-07-24,partly-cloudy-day,nan
812,453,359,2018-06-24,cloudy,nan
1234,579,655,2018-06-21,clear-day,nan
3047,1430,1617,2018-07-28,partly-cloudy-day,nan
14,8,6,2018-07-04,clear-night,Independence Day
1042,1042,0,2018-07-13,clear-day,nan
1786,856,930,2018-07-06,partly-cloudy-day,nan
1507,666,841,2018-07-11,partly-cloudy-day,nan
264,122,142,2018-07-27,rain,nan
567,228,339,2018-07-18,clear-night,nan
14,8,6,2018-07-30,clear-night,nan
1938,1093,845,2018-06-25,clear-day,nan
1797,767,1030,2018-07-09,clear-day,nan
12,5,7,2018-07-22,rain,nan
862,351,511,2018-07-24,partly-cloudy-night,nan
57,23,34,2018-06-19,clear-night,nan
24,5,19,2018-07-08,clear-night,nan
57,46,11,2018-07-29,clear-night,nan
1443,709,734,2018-07-26,clear-day,nan
2526,1201,1325,2018-07-28,partly-cloudy-day,nan
1873,979,894,2018-07-12,partly-cloudy-day,nan
109,35,74,2018-07-23,rain,nan
247,111,136,2018-06-29,clear-day,nan
597,220,377,2018-06-12,clear-night,nan
27,13,14,2018-07-28,partly-cloudy-night,nan
452,146,306,2018-06-20,clear-day,nan
1062,564,498,2018-07-24,partly-cloudy-day,nan
1446,657,789,2018-06-28,rain,nan
1864,989,875,2018-06-14,clear-day,nan
599,239,360,2018-07-29,partly-cloudy-night,nan
417,148,269,2018-06-27,partly-cloudy-day,nan
1530,655,875,2018-06-19,partly-cloudy-day,nan
52,32,20,2018-07-07,clear-night,nan
577,292,285,2018-06-18,clear-day,nan
2029,1109,920,2018-07-18,partly-cloudy-day,nan
742,308,434,2018-07-07,clear-night,nan
11,1,10,2018-07-15,rain,nan
150,76,74,2018-06-30,clear-night,nan
44,25,19,2018-07-29,clear-night,nan
228,102,126,2018-07-03,clear-day,nan
1894,971,923,2018-07-23,partly-cloudy-day,nan
75,45,30,2018-07-18,partly-cloudy-night,nan
124,79,45,2018-06-17,clear-night,Father's Day
4,1,3,2018-06-26,clear-night,nan
12,6,6,2018-07-02,clear-night,nan
7,7,0,2018-06-23,cloudy,nan
385,158,227,2018-07-19,clear-day,nan
1265,631,634,2018-07-30,partly-cloudy-day,nan
98,37,61,2018-07-25,rain,nan
2057,905,1152,2018-07-27,partly-cloudy-day,nan
1554,734,820,2018-07-02,clear-day,nan
1980,966,1014,2018-06-17,clear-day,Father's Day
947,302,645,2018-06-21,clear-night,nan
1998,890,1108,2018-06-26,clear-day,nan
794,533,261,2018-07-21,partly-cloudy-day,nan
1609,814,795,2018-06-15,partly-cloudy-day,nan
2153,904,1249,2018-07-05,partly-cloudy-day,nan
723,723,0,2018-07-13,clear-night,nan
2146,1165,981,2018-07-31,partly-cloudy-day,nan
1493,647,846,2018-06-20,partly-cloudy-day,nan
588,588,0,2018-07-04,clear-night,Independence Day
542,280,262,2018-07-10,clear-day,nan
41,24,17,2018-07-20,clear-night,nan
7,3,4,2018-07-11,partly-cloudy-night,nan
222,100,122,2018-07-27,clear-day,nan
387,163,224,2018-07-02,clear-day,nan
192,97,95,2018-07-09,clear-day,nan
1124,660,464,2018-07-04,partly-cloudy-day,Independence Day
42,20,22,2018-07-09,clear-night,nan
1114,333,781,2018-07-02,clear-night,nan
1287,619,668,2018-07-24,partly-cloudy-day,nan
26,12,14,2018-07-07,clear-night,nan
1456,859,597,2018-07-10,clear-day,nan
887,438,449,2018-07-25,rain,nan
164,58,106,2018-07-22,cloudy,nan
2422,1118,1304,2018-07-30,partly-cloudy-day,nan
175,70,105,2018-07-05,partly-cloudy-day,nan
253,108,145,2018-06-21,cloudy,nan
410,160,250,2018-07-11,partly-cloudy-night,nan
2452,1247,1205,2018-06-16,clear-day,nan
1440,919,521,2018-07-08,clear-day,nan
563,299,264,2018-07-17,partly-cloudy-day,nan
689,319,370,2018-06-28,partly-cloudy-night,nan
916,342,574,2018-07-28,clear-night,nan
1465,752,713,2018-07-09,clear-day,nan
30,12,18,2018-07-24,partly-cloudy-night,nan
216,95,121,2018-07-28,partly-cloudy-day,nan
1768,778,990,2018-07-23,partly-cloudy-day,nan
1807,1024,783,2018-07-11,partly-cloudy-day,nan
388,223,165,2018-07-03,clear-night,nan
1245,676,569,2018-07-30,partly-cloudy-day,nan
156,156,0,2018-07-13,clear-day,nan
2993,1301,1692,2018-07-29,partly-cloudy-day,nan
1755,1003,752,2018-07-09,clear-day,nan
2176,1085,1091,2018-07-26,partly-cloudy-day,nan
145,73,72,2018-07-26,partly-cloudy-day,nan
1354,693,661,2018-07-01,clear-day,nan
1557,795,762,2018-07-23,partly-cloudy-day,nan
1397,781,616,2018-06-19,clear-day,nan
1952,979,973,2018-07-20,partly-cloudy-day,nan
1895,878,1017,2018-07-12,partly-cloudy-day,nan
23,16,7,2018-06-13,partly-cloudy-night,nan
1007,400,607,2018-06-17,clear-night,Father's Day
154,72,82,2018-07-24,partly-cloudy-day,nan
38,16,22,2018-07-06,cloudy,nan
58,34,24,2018-06-14,clear-night,nan
509,296,213,2018-07-14,clear-night,nan
130,92,38,2018-06-27,cloudy,nan
1336,684,652,2018-07-03,clear-day,nan
2966,1324,1642,2018-07-07,clear-day,nan
8,5,3,2018-06-18,clear-night,nan
2082,921,1161,2018-06-15,partly-cloudy-day,nan
1496,613,883,2018-06-17,clear-day,Father's Day
1572,862,710,2018-06-26,partly-cloudy-day,nan
647,351,296,2018-06-22,partly-cloudy-day,nan
1247,355,892,2018-06-16,clear-night,nan
2154,1071,1083,2018-06-22,partly-cloudy-day,nan
1552,735,817,2018-07-15,partly-cloudy-day,nan
2190,1018,1172,2018-06-12,clear-day,nan
558,281,277,2018-07-27,rain,nan
3822,1839,1983,2018-07-21,partly-cloudy-day,nan
2566,1176,1390,2018-06-23,cloudy,nan
1073,335,738,2018-07-08,clear-night,nan
1505,670,835,2018-06-27,cloudy,nan
33,19,14,2018-07-16,clear-night,nan
16,8,8,2018-06-21,cloudy,nan
1630,734,896,2018-07-03,rain,nan
1816,927,889,2018-06-25,partly-cloudy-day,nan
1064,303,761,2018-07-20,clear-night,nan
28,9,19,2018-07-05,clear-night,nan
861,250,611,2018-07-09,clear-night,nan
818,538,280,2018-07-14,partly-cloudy-day,nan
1183,735,448,2018-07-26,partly-cloudy-day,nan
201,101,100,2018-07-31,partly-cloudy-day,nan
12,7,5,2018-06-29,clear-night,nan
1704,860,844,2018-07-25,cloudy,nan
2101,1102,999,2018-07-05,clear-day,nan
11,8,3,2018-07-27,clear-night,nan
248,109,139,2018-07-31,partly-cloudy-night,nan
1228,472,756,2018-07-10,clear-day,nan
49,16,33,2018-07-25,rain,nan
18,10,8,2018-07-31,clear-night,nan
2610,1296,1314,2018-07-04,rain,Independence Day
16,9,7,2018-07-22,rain,nan
880,331,549,2018-07-31,partly-cloudy-night,nan
2488,1179,1309,2018-07-14,partly-cloudy-day,nan
2481,1234,1247,2018-07-15,partly-cloudy-day,nan
563,223,340,2018-07-06,clear-night,nan
13,6,7,2018-07-10,clear-night,nan
1131,645,486,2018-07-12,partly-cloudy-day,nan
1868,953,915,2018-07-19,clear-day,nan
52,32,20,2018-07-21,partly-cloudy-night,nan
158,86,72,2018-07-20,clear-day,nan
266,85,181,2018-06-24,cloudy,nan
2350,1080,1270,2018-07-29,partly-cloudy-day,nan
1705,869,836,2018-06-29,clear-day,nan
2542,988,1554,2018-07-22,partly-cloudy-day,nan
1514,1514,0,2018-07-13,clear-day,nan
95,51,44,2018-07-08,clear-day,nan
63,44,19,2018-06-30,clear-night,nan
852,424,428,2018-07-03,clear-night,nan
173,80,93,2018-07-30,partly-cloudy-day,nan
1532,969,563,2018-06-30,clear-day,nan
2478,1324,1154,2018-07-28,partly-cloudy-day,nan
1510,604,906,2018-07-16,clear-day,nan
1058,589,469,2018-06-19,partly-cloudy-day,nan
759,442,317,2018-06-13,partly-cloudy-day,nan
338,171,167,2018-06-13,clear-night,nan
1356,701,655,2018-06-18,partly-cloudy-day,nan
1938,940,998,2018-06-23,cloudy,nan
847,490,357,2018-06-14,clear-day,nan
14,8,6,2018-07-18,partly-cloudy-night,nan
85,52,33,2018-06-19,clear-night,nan
1729,1729,0,2018-07-13,clear-day,nan
19,7,12,2018-06-24,cloudy,nan
10,7,3,2018-06-15,clear-night,nan
347,202,145,2018-07-06,partly-cloudy-day,nan
180,134,46,2018-06-20,clear-night,nan
75,45,30,2018-07-11,partly-cloudy-night,nan
1339,555,784,2018-06-24,partly-cloudy-day,nan
36,19,17,2018-06-13,cloudy,nan
179,87,92,2018-07-01,clear-night,nan
1522,799,723,2018-06-18,partly-cloudy-day,nan
6,4,2,2018-06-28,cloudy,nan
27,16,11,2018-07-13,clear-night,nan
3633,1679,1954,2018-07-07,clear-day,nan
1556,774,782,2018-07-06,clear-day,nan
2294,1104,1190,2018-07-30,partly-cloudy-day,nan
1604,725,879,2018-07-16,partly-cloudy-day,nan
552,193,359,2018-07-05,clear-night,nan
10,7,3,2018-07-20,clear-night,nan
8,3,5,2018-07-23,cloudy,nan
1273,635,638,2018-06-19,clear-day,nan
28,21,7,2018-06-30,clear-night,nan
1904,1164,740,2018-07-24,partly-cloudy-day,nan
1172,564,608,2018-07-11,clear-day,nan
1248,683,565,2018-06-20,clear-day,nan
158,70,88,2018-06-29,clear-day,nan
169,132,37,2018-07-13,clear-night,nan
806,458,348,2018-06-13,cloudy,nan
496,173,323,2018-06-14,clear-day,nan
320,129,191,2018-07-17,rain,nan
873,573,300,2018-07-29,partly-cloudy-day,nan
2833,1215,1618,2018-07-14,partly-cloudy-day,nan
1295,739,556,2018-06-24,cloudy,nan
1155,1155,0,2018-07-13,clear-day,nan
305,132,173,2018-07-18,clear-night,nan
399,131,268,2018-07-16,clear-night,nan
1175,567,608,2018-07-06,cloudy,nan
10,0,10,2018-07-12,partly-cloudy-night,nan
1761,865,896,2018-07-06,partly-cloudy-day,nan
2379,1070,1309,2018-06-24,partly-cloudy-day,nan
1498,876,622,2018-07-22,cloudy,nan
298,183,115,2018-06-14,clear-night,nan
1136,633,503,2018-06-17,clear-day,Father's Day
360,245,115,2018-07-29,partly-cloudy-day,nan
88,36,52,2018-06-24,cloudy,nan
64,39,25,2018-06-21,cloudy,nan
55,33,22,2018-07-05,partly-cloudy-night,nan
143,64,79,2018-06-23,cloudy,nan
1152,600,552,2018-06-13,cloudy,nan
1547,828,719,2018-06-29,clear-day,nan
59,33,26,2018-07-09,clear-night,nan
1666,893,773,2018-06-15,partly-cloudy-day,nan
935,515,420,2018-06-28,partly-cloudy-day,nan
427,225,202,2018-07-29,clear-night,nan
64,35,29,2018-06-13,clear-night,nan
82,33,49,2018-07-01,clear-night,nan
3176,1535,1641,2018-07-21,partly-cloudy-day,nan
516,314,202,2018-06-28,partly-cloudy-day,nan
1579,884,695,2018-06-14,partly-cloudy-day,nan
135,56,79,2018-07-06,partly-cloudy-day,nan
1972,886,1086,2018-06-25,partly-cloudy-day,nan
428,223,205,2018-07-07,clear-night,nan
91,52,39,2018-07-15,rain,nan
1191,594,597,2018-06-18,clear-day,nan
52,30,22,2018-07-12,partly-cloudy-night,nan
165,76,89,2018-07-03,clear-day,nan
2285,959,1326,2018-07-26,partly-cloudy-day,nan
3109,1406,1703,2018-07-28,partly-cloudy-day,nan
2077,802,1275,2018-06-14,clear-day,nan
604,222,382,2018-07-01,clear-night,nan
92,49,43,2018-07-28,partly-cloudy-night,nan
1588,813,775,2018-06-26,partly-cloudy-day,nan
107,50,57,2018-07-27,rain,nan
384,147,237,2018-06-22,partly-cloudy-day,nan
1885,1014,871,2018-07-20,partly-cloudy-day,nan
87,39,48,2018-07-16,clear-night,nan
20,12,8,2018-06-20,clear-night,nan
1402,644,758,2018-07-11,partly-cloudy-day,nan
43,31,12,2018-07-21,rain,nan
17,7,10,2018-06-27,partly-cloudy-night,nan
143,57,86,2018-07-05,partly-cloudy-night,nan
37,21,16,2018-06-16,clear-night,nan
8,0,8,2018-06-19,partly-cloudy-night,nan
1443,595,848,2018-07-10,clear-day,nan
361,212,149,2018-07-14,clear-day,nan
61,27,34,2018-07-23,rain,nan
3345,1512,1833,2018-07-07,clear-day,nan
296,119,177,2018-06-20,clear-day,nan
102,38,64,2018-07-20,clear-night,nan
1229,697,532,2018-06-29,clear-day,nan
1409,639,770,2018-06-19,clear-day,nan
6,5,1,2018-07-17,clear-night,nan
115,55,60,2018-06-17,clear-night,Father's Day
816,322,494,2018-07-10,partly-cloudy-night,nan
1599,733,866,2018-06-21,partly-cloudy-day,nan
477,216,261,2018-06-23,cloudy,nan
4,2,2,2018-07-15,rain,nan
131,50,81,2018-07-29,clear-night,nan
2130,1005,1125,2018-07-24,partly-cloudy-day,nan
360,161,199,2018-06-29,clear-night,nan
635,635,0,2018-06-15,partly-cloudy-night,nan
10,2,8,2018-07-26,cloudy,nan
16,11,5,2018-07-13,clear-night,nan
18,10,8,2018-06-28,rain,nan
1695,833,862,2018-07-23,partly-cloudy-day,nan
93,41,52,2018-07-24,partly-cloudy-night,nan
21,12,9,2018-06-22,partly-cloudy-night,nan
1912,893,1019,2018-06-27,cloudy,nan
246,158,88,2018-07-01,clear-day,nan
2118,1056,1062,2018-06-15,partly-cloudy-day,nan
20,12,8,2018-07-06,partly-cloudy-night,nan
1437,791,646,2018-06-12,clear-day,nan
14,11,3,2018-07-30,clear-night,nan
2202,1046,1156,2018-06-22,partly-cloudy-day,nan
114,89,25,2018-07-13,clear-night,nan
1812,1067,745,2018-06-25,partly-cloudy-day,nan
1444,697,747,2018-07-03,rain,nan
6,3,3,2018-07-19,clear-night,nan
4,3,1,2018-06-14,partly-cloudy-night,nan
1727,732,995,2018-07-09,clear-day,nan
187,130,57,2018-07-25,cloudy,nan
2091,1106,985,2018-06-30,clear-day,nan
2698,1177,1521,2018-06-16,clear-day,nan
6,3,3,2018-07-08,clear-night,nan
6,5,1,2018-06-25,clear-night,nan
145,57,88,2018-07-29,clear-day,nan
1493,714,779,2018-06-23,cloudy,nan
7,2,5,2018-06-21,rain,nan
2514,1413,1101,2018-07-07,clear-day,nan
1671,810,861,2018-07-18,clear-day,nan
1501,762,739,2018-07-31,partly-cloudy-day,nan
2360,1098,1262,2018-07-19,clear-day,nan
664,338,326,2018-07-02,clear-day,nan
223,87,136,2018-07-16,clear-day,nan
1396,686,710,2018-06-28,partly-cloudy-day,nan
7,6,1,2018-07-03,clear-night,nan
2053,956,1097,2018-07-27,partly-cloudy-day,nan
1968,988,980,2018-07-08,clear-day,nan
38,14,24,2018-07-14,clear-night,nan
821,280,541,2018-06-26,clear-night,nan
202,100,102,2018-07-18,partly-cloudy-day,nan
939,498,441,2018-06-27,cloudy,nan
1915,903,1012,2018-07-05,partly-cloudy-day,nan
1251,1251,0,2018-07-04,partly-cloudy-day,Independence Day
1640,843,797,2018-07-16,clear-day,nan
2241,1155,1086,2018-06-16,clear-day,nan
1325,485,840,2018-07-07,clear-night,nan
234,94,140,2018-06-25,clear-night,nan
117,60,57,2018-07-07,clear-day,nan
413,172,241,2018-06-18,clear-day,nan
1929,930,999,2018-07-15,clear-day,nan
378,205,173,2018-06-21,cloudy,nan
520,165,355,2018-07-30,clear-night,nan
1844,1115,729,2018-07-12,partly-cloudy-day,nan
900,518,382,2018-07-08,clear-day,nan
262,117,145,2018-06-16,clear-day,nan
1366,631,735,2018-07-02,clear-day,nan
525,244,281,2018-07-17,cloudy,nan
1434,702,732,2018-07-11,partly-cloudy-day,nan
13,7,6,2018-07-04,partly-cloudy-night,Independence Day
154,74,80,2018-06-15,clear-day,nan
1892,899,993,2018-06-22,partly-cloudy-day,nan
103,52,51,2018-06-22,cloudy,nan
267,172,95,2018-07-25,partly-cloudy-day,nan
1842,1070,772,2018-07-19,clear-day,nan
684,361,323,2018-07-30,partly-cloudy-day,nan
2562,1146,1416,2018-07-22,partly-cloudy-day,nan
2843,1265,1578,2018-07-08,clear-day,nan
2679,1272,1407,2018-07-20,partly-cloudy-day,nan
2851,1281,1570,2018-07-14,clear-day,nan
924,326,598,2018-07-21,partly-cloudy-day,nan
13,8,5,2018-07-25,partly-cloudy-night,nan
417,126,291,2018-07-10,clear-day,nan
139,52,87,2018-06-18,clear-night,nan
1695,921,774,2018-06-20,partly-cloudy-day,nan
2111,907,1204,2018-07-31,partly-cloudy-day,nan
261,164,97,2018-06-17,clear-night,Father's Day
233,104,129,2018-06-26,clear-day,nan
1486,707,779,2018-07-01,clear-day,nan
434,248,186,2018-07-21,partly-cloudy-day,nan
2091,1058,1033,2018-07-26,partly-cloudy-day,nan
2262,888,1374,2018-07-28,partly-cloudy-day,nan
2230,1091,1139,2018-07-20,partly-cloudy-day,nan
23,15,8,2018-07-11,partly-cloudy-night,nan
38,32,6,2018-07-04,clear-night,Independence Day
309,128,181,2018-07-31,partly-cloudy-day,nan
1280,652,628,2018-07-23,partly-cloudy-day,nan
685,289,396,2018-06-17,clear-night,Father's Day
10,4,6,2018-06-29,clear-night,nan
2134,1127,1007,2018-07-22,partly-cloudy-day,nan
2537,1242,1295,2018-07-14,partly-cloudy-day,nan
195,76,119,2018-07-16,clear-night,nan
104,57,47,2018-07-09,clear-night,nan
33,10,23,2018-07-26,cloudy,nan
1289,616,673,2018-07-11,clear-day,nan
488,202,286,2018-07-26,clear-night,nan
35,15,20,2018-06-24,cloudy,nan
1967,935,1032,2018-07-18,partly-cloudy-day,nan
180,69,111,2018-07-15,partly-cloudy-night,nan
983,503,480,2018-07-01,clear-day,nan
259,109,150,2018-07-19,clear-day,nan
1594,790,804,2018-07-24,partly-cloudy-day,nan
1813,814,999,2018-07-31,partly-cloudy-day,nan
1285,808,477,2018-06-21,clear-day,nan
2545,976,1569,2018-07-07,clear-day,nan
386,170,216,2018-06-28,clear-night,nan
1782,862,920,2018-07-23,partly-cloudy-day,nan
142,65,77,2018-06-25,partly-cloudy-day,nan
11,6,5,2018-06-18,clear-night,nan
1522,539,983,2018-07-28,partly-cloudy-night,nan
217,74,143,2018-07-05,clear-night,nan
9,4,5,2018-07-24,partly-cloudy-night,nan
203,123,80,2018-06-24,partly-cloudy-night,nan
583,284,299,2018-06-21,partly-cloudy-night,nan
2154,929,1225,2018-06-12,clear-day,nan
2477,1026,1451,2018-06-23,cloudy,nan
129,70,59,2018-07-17,cloudy,nan
1712,1007,705,2018-07-28,partly-cloudy-day,nan
1610,721,889,2018-07-03,partly-cloudy-day,nan
2054,1027,1027,2018-06-30,clear-day,nan
3830,3657,173,2018-06-30,clear-day,nan
2063,902,1161,2018-06-22,partly-cloudy-day,nan
861,861,0,2018-06-15,clear-day,nan
1865,1121,744,2018-07-09,clear-day,nan
667,285,382,2018-07-20,clear-night,nan
1166,600,566,2018-06-19,partly-cloudy-day,nan
161,88,73,2018-06-13,clear-night,nan
430,158,272,2018-07-09,clear-night,nan
49,32,17,2018-07-02,clear-night,nan
340,141,199,2018-07-27,clear-day,nan
2008,867,1141,2018-07-12,partly-cloudy-day,nan
1485,679,806,2018-07-25,cloudy,nan
517,177,340,2018-07-02,clear-night,nan
1264,570,694,2018-07-10,clear-day,nan
151,81,70,2018-06-30,clear-day,nan
17,5,12,2018-07-31,clear-night,nan
80,40,40,2018-07-07,clear-night,nan
187,84,103,2018-06-19,clear-day,nan
2727,1434,1293,2018-07-04,rain,Independence Day
231,86,145,2018-07-21,cloudy,nan
2319,1063,1256,2018-07-15,clear-day,nan
1275,620,655,2018-07-10,clear-day,nan
5,0,5,2018-07-10,clear-night,nan
289,129,160,2018-07-05,partly-cloudy-day,nan
17,8,9,2018-07-21,partly-cloudy-night,nan
8,4,4,2018-06-28,cloudy,nan
8,6,2,2018-06-23,cloudy,nan
2390,1116,1274,2018-07-29,partly-cloudy-day,nan
1523,720,803,2018-07-09,clear-day,nan
99,26,73,2018-06-21,cloudy,nan
1612,928,684,2018-07-02,clear-day,nan
20,11,9,2018-06-17,clear-night,Father's Day
381,137,244,2018-07-16,clear-day,nan
2032,933,1099,2018-07-27,partly-cloudy-day,nan
1947,1947,0,2018-07-13,clear-day,nan
61,44,17,2018-07-08,clear-night,nan
145,82,63,2018-07-04,clear-night,Independence Day
3512,1614,1898,2018-07-21,partly-cloudy-day,nan
1809,1068,741,2018-06-26,partly-cloudy-day,nan
1892,902,990,2018-06-17,clear-day,Father's Day
65,45,20,2018-07-30,clear-night,nan
473,154,319,2018-07-24,partly-cloudy-night,nan
305,142,163,2018-06-27,partly-cloudy-day,nan
395,395,0,2018-07-13,clear-night,nan
2123,854,1269,2018-07-05,partly-cloudy-day,nan
639,214,425,2018-07-22,rain,nan
1638,765,873,2018-07-01,clear-day,nan
2138,1189,949,2018-07-31,partly-cloudy-day,nan
1626,994,632,2018-07-16,clear-day,nan
351,130,221,2018-07-17,partly-cloudy-day,nan
1579,722,857,2018-06-20,partly-cloudy-day,nan
1195,553,642,2018-06-18,clear-day,nan
33,20,13,2018-07-26,cloudy,nan
2040,873,1167,2018-07-14,partly-cloudy-day,nan
1775,801,974,2018-06-14,clear-day,nan
620,379,241,2018-07-04,partly-cloudy-day,Independence Day
6,4,2,2018-07-12,partly-cloudy-night,nan
2086,1032,1054,2018-07-05,clear-day,nan
211,85,126,2018-07-24,partly-cloudy-day,nan
1829,853,976,2018-07-06,partly-cloudy-day,nan
7,4,3,2018-07-18,partly-cloudy-night,nan
196,88,108,2018-07-11,partly-cloudy-day,nan
10,4,6,2018-06-15,clear-night,nan
5,4,1,2018-07-09,clear-night,nan
43,20,23,2018-07-25,cloudy,nan
1730,848,882,2018-06-24,partly-cloudy-day,nan
148,66,82,2018-06-13,partly-cloudy-day,nan
15,4,11,2018-07-27,clear-night,nan
1480,664,816,2018-07-18,clear-day,nan
787,254,533,2018-07-11,partly-cloudy-night,nan
81,37,44,2018-06-24,cloudy,nan
2206,1034,1172,2018-07-30,partly-cloudy-day,nan
1437,844,593,2018-06-18,partly-cloudy-day,nan
172,64,108,2018-07-11,partly-cloudy-night,nan
1669,864,805,2018-07-19,clear-day,nan
1635,851,784,2018-06-29,clear-day,nan
67,30,37,2018-07-22,cloudy,nan
1985,1102,883,2018-06-16,clear-day,nan
14,6,8,2018-06-26,clear-night,nan
51,34,17,2018-07-22,cloudy,nan
191,191,0,2018-07-13,clear-day,nan
1830,809,1021,2018-06-29,partly-cloudy-day,nan
1616,851,765,2018-06-23,cloudy,nan
141,63,78,2018-07-28,partly-cloudy-day,nan
1175,613,562,2018-06-25,partly-cloudy-day,nan
687,298,389,2018-07-23,partly-cloudy-night,nan
1971,862,1109,2018-06-14,clear-day,nan
571,285,286,2018-07-26,partly-cloudy-day,nan
289,114,175,2018-06-15,clear-day,nan
1307,686,621,2018-06-20,partly-cloudy-day,nan
1227,503,724,2018-07-10,clear-day,nan
917,332,585,2018-06-19,clear-night,nan
1147,666,481,2018-07-15,partly-cloudy-day,nan
13,8,5,2018-06-20,clear-night,nan
271,118,153,2018-06-26,clear-day,nan
463,206,257,2018-07-31,partly-cloudy-night,nan
1331,445,886,2018-06-30,clear-night,nan
10,6,4,2018-06-13,cloudy,nan
1169,581,588,2018-07-25,partly-cloudy-day,nan
1003,358,645,2018-07-06,clear-night,nan
145,63,82,2018-06-27,cloudy,nan
571,254,317,2018-07-12,partly-cloudy-day,nan
1007,530,477,2018-07-03,clear-day,nan
1422,602,820,2018-07-17,partly-cloudy-day,nan
1547,850,697,2018-07-01,clear-day,nan
1881,909,972,2018-06-17,clear-day,Father's Day
2029,796,1233,2018-06-26,clear-day,nan
607,260,347,2018-07-27,rain,nan
24,14,10,2018-07-02,clear-night,nan
1224,536,688,2018-07-06,cloudy,nan
3,0,3,2018-07-22,rain,nan
26,15,11,2018-07-16,clear-night,nan
1292,690,602,2018-06-27,cloudy,nan
2739,1272,1467,2018-07-29,partly-cloudy-day,nan
265,93,172,2018-07-09,clear-day,nan
9,7,2,2018-07-05,partly-cloudy-night,nan
259,120,139,2018-07-20,clear-day,nan
879,509,370,2018-06-13,partly-cloudy-day,nan
1513,1513,0,2018-07-13,partly-cloudy-day,nan
1860,975,885,2018-06-26,partly-cloudy-day,nan
1488,806,682,2018-07-11,partly-cloudy-day,nan
41,24,17,2018-07-30,clear-night,nan
1610,762,848,2018-07-09,clear-day,nan
11,7,4,2018-07-25,cloudy,nan
78,31,47,2018-07-08,clear-night,nan
232,113,119,2018-06-18,rain,nan
3087,1618,1469,2018-07-07,clear-day,nan
308,106,202,2018-07-26,partly-cloudy-day,nan
1936,916,1020,2018-07-18,clear-day,nan
171,88,83,2018-06-12,clear-night,nan
1541,868,673,2018-07-12,clear-day,nan
2128,925,1203,2018-06-15,partly-cloudy-day,nan
1235,736,499,2018-06-19,clear-day,nan
18,5,13,2018-07-28,partly-cloudy-night,nan
35,21,14,2018-07-23,rain,nan
128,42,86,2018-07-30,clear-night,nan
1117,483,634,2018-06-28,partly-cloudy-day,nan
1765,779,986,2018-07-24,wind,nan
1963,874,1089,2018-06-25,partly-cloudy-day,nan
30,22,8,2018-07-01,clear-night,nan
64,32,32,2018-07-06,rain,nan
228,113,115,2018-07-07,clear-day,nan
151,97,54,2018-07-08,clear-night,nan
1342,617,725,2018-06-18,clear-day,nan
58,33,25,2018-07-03,clear-night,nan
258,108,150,2018-06-14,clear-day,nan
113,43,70,2018-07-19,clear-night,nan
302,139,163,2018-07-18,clear-day,nan
1401,721,680,2018-07-23,partly-cloudy-day,nan
339,182,157,2018-07-17,rain,nan
407,173,234,2018-06-22,partly-cloudy-night,nan
1019,320,699,2018-07-01,clear-night,nan
11,8,3,2018-06-22,partly-cloudy-night,nan
2773,1190,1583,2018-07-08,clear-day,nan
95,41,54,2018-07-01,clear-day,nan
1810,684,1126,2018-07-27,rain,nan
2918,1319,1599,2018-06-16,clear-day,nan
2048,965,1083,2018-07-31,partly-cloudy-day,nan
1864,806,1058,2018-06-27,cloudy,nan
2080,1060,1020,2018-07-05,clear-day,nan
215,119,96,2018-07-21,partly-cloudy-day,nan
449,449,0,2018-07-04,partly-cloudy-night,Independence Day
19,11,8,2018-06-16,clear-night,nan
1465,597,868,2018-07-02,clear-day,nan
191,127,64,2018-06-20,cloudy,nan
1183,621,562,2018-07-10,clear-day,nan
2222,1116,1106,2018-07-30,partly-cloudy-day,nan
9,7,2,2018-07-23,cloudy,nan
3,2,1,2018-07-11,partly-cloudy-night,nan
23,14,9,2018-07-20,clear-night,nan
291,148,143,2018-07-04,partly-cloudy-day,Independence Day
2104,1087,1017,2018-07-06,partly-cloudy-day,nan
4,0,4,2018-07-03,clear-night,nan
17,12,5,2018-07-14,clear-night,nan
2328,978,1350,2018-07-19,clear-day,nan
1486,628,858,2018-06-21,partly-cloudy-day,nan
1753,1125,628,2018-07-29,partly-cloudy-day,nan
1896,753,1143,2018-06-16,clear-day,nan
2226,969,1257,2018-07-24,partly-cloudy-day,nan
579,241,338,2018-06-27,cloudy,nan
324,127,197,2018-07-17,rain,nan
2735,1291,1444,2018-07-14,partly-cloudy-day,nan
3024,1456,1568,2018-07-28,partly-cloudy-day,nan
166,82,84,2018-07-07,clear-night,nan
1427,730,697,2018-07-11,partly-cloudy-day,nan
3028,1468,1560,2018-07-22,partly-cloudy-day,nan
484,260,224,2018-07-16,clear-day,nan
3012,1329,1683,2018-07-22,partly-cloudy-day,nan
67,33,34,2018-07-04,clear-night,Independence Day
1655,971,684,2018-06-25,clear-day,nan
1620,743,877,2018-07-19,clear-day,nan
2149,2149,0,2018-07-13,partly-cloudy-day,nan
16,9,7,2018-06-14,partly-cloudy-night,nan
13,9,4,2018-06-25,partly-cloudy-night,nan
1932,1097,835,2018-07-26,partly-cloudy-day,nan
1059,511,548,2018-06-13,cloudy,nan
29,18,11,2018-07-21,rain,nan
831,469,362,2018-07-28,partly-cloudy-day,nan
98,65,33,2018-06-23,cloudy,nan
5,4,1,2018-06-19,partly-cloudy-night,nan
1781,867,914,2018-07-09,clear-day,nan
8,4,4,2018-06-27,partly-cloudy-night,nan
971,581,390,2018-06-28,partly-cloudy-day,nan
214,100,114,2018-06-20,clear-day,nan
1558,905,653,2018-06-14,clear-day,nan
133,67,66,2018-06-17,clear-day,Father's Day
1911,778,1133,2018-07-08,clear-day,nan
56,33,23,2018-06-29,clear-night,nan
1616,839,777,2018-06-19,clear-day,nan
263,109,154,2018-06-18,clear-day,nan
421,265,156,2018-07-12,clear-night,nan
637,318,319,2018-06-29,clear-night,nan
36,22,14,2018-07-15,rain,nan
20,11,9,2018-07-15,rain,nan
984,537,447,2018-06-13,cloudy,nan
192,67,125,2018-07-23,partly-cloudy-night,nan
1098,514,584,2018-06-12,clear-day,nan
2189,1117,1072,2018-06-15,partly-cloudy-day,nan
617,398,219,2018-07-25,cloudy,nan
11,5,6,2018-07-06,partly-cloudy-night,nan
2386,1148,1238,2018-06-24,partly-cloudy-day,nan
1784,902,882,2018-06-17,clear-day,Father's Day
432,195,237,2018-06-14,clear-night,nan
2509,1050,1459,2018-07-20,partly-cloudy-day,nan
39,14,25,2018-06-28,rain,nan
260,117,143,2018-06-22,partly-cloudy-day,nan
1775,857,918,2018-06-22,partly-cloudy-day,nan
2404,2071,333,2018-06-30,clear-day,nan
1232,561,671,2018-07-03,partly-cloudy-day,nan
1,0,1,2018-06-21,rain,nan
291,124,167,2018-07-10,clear-day,nan
36,30,6,2018-07-21,partly-cloudy-night,nan
612,294,318,2018-07-27,clear-day,nan
871,467,404,2018-07-02,clear-day,nan
273,124,149,2018-07-14,clear-day,nan
1017,439,578,2018-06-23,cloudy,nan
872,469,403,2018-06-28,partly-cloudy-day,nan
284,137,147,2018-07-19,clear-night,nan
10,3,7,2018-07-17,clear-night,nan
53,26,27,2018-07-11,partly-cloudy-night,nan
429,155,274,2018-06-26,clear-night,nan
664,368,296,2018-07-05,cloudy,nan
925,925,0,2018-07-04,partly-cloudy-day,Independence Day
370,370,0,2018-06-15,partly-cloudy-night,nan
27,12,15,2018-07-26,partly-cloudy-night,nan
381,151,230,2018-07-12,partly-cloudy-day,nan
958,631,327,2018-06-21,partly-cloudy-day,nan
902,239,663,2018-07-30,partly-cloudy-night,nan
1727,705,1022,2018-07-15,clear-day,nan
1966,1012,954,2018-06-24,partly-cloudy-day,nan
295,162,133,2018-07-29,clear-night,nan
2810,1330,1480,2018-07-29,partly-cloudy-day,nan
1336,759,577,2018-06-18,partly-cloudy-day,nan
75,36,39,2018-06-25,partly-cloudy-night,nan
3,1,2,2018-07-24,partly-cloudy-night,nan
370,223,147,2018-07-08,clear-day,nan
974,974,0,2018-07-13,clear-day,nan
39,16,23,2018-07-01,clear-night,nan
2072,943,1129,2018-06-25,partly-cloudy-day,nan
3445,3307,138,2018-06-30,clear-day,nan
64,36,28,2018-07-17,partly-cloudy-night,nan
1887,944,943,2018-06-29,clear-day,nan
65,32,33,2018-06-14,partly-cloudy-night,nan
1129,559,570,2018-07-22,rain,nan
4,2,2,2018-07-22,rain,nan
64,34,30,2018-07-28,partly-cloudy-night,nan
1317,576,741,2018-06-19,partly-cloudy-day,nan
275,112,163,2018-07-17,partly-cloudy-day,nan
1224,664,560,2018-06-23,cloudy,nan
1316,610,706,2018-06-18,partly-cloudy-day,nan
1111,641,470,2018-06-13,cloudy,nan
2009,907,1102,2018-06-14,clear-day,nan
1544,719,825,2018-07-16,partly-cloudy-day,nan
715,382,333,2018-06-29,clear-day,nan
11,8,3,2018-07-18,partly-cloudy-night,nan
973,489,484,2018-06-20,clear-day,nan
12,3,9,2018-06-20,clear-night,nan
168,68,100,2018-06-13,cloudy,nan
402,159,243,2018-07-30,clear-day,nan
52,29,23,2018-06-30,clear-night,nan
937,444,493,2018-07-15,partly-cloudy-day,nan
2421,1142,1279,2018-07-18,partly-cloudy-day,nan
892,467,425,2018-06-23,cloudy,nan
1971,856,1115,2018-07-18,clear-day,nan
23,12,11,2018-06-28,cloudy,nan
3539,1640,1899,2018-07-07,clear-day,nan
9,4,5,2018-07-13,clear-night,nan
93,45,48,2018-07-06,clear-night,nan
76,42,34,2018-06-25,partly-cloudy-night,nan
81,31,50,2018-06-21,partly-cloudy-day,nan
12,11,1,2018-06-26,clear-night,nan
427,197,230,2018-06-16,partly-cloudy-night,nan
1985,1008,977,2018-06-22,partly-cloudy-day,nan
2038,877,1161,2018-06-22,partly-cloudy-day,nan
1893,964,929,2018-06-12,clear-day,nan
1875,840,1035,2018-06-24,partly-cloudy-day,nan
1765,871,894,2018-06-17,clear-day,Father's Day
2164,1145,1019,2018-07-20,partly-cloudy-day,nan
1034,301,733,2018-07-15,clear-night,nan
10,3,7,2018-06-18,clear-night,nan
1981,1014,967,2018-06-26,clear-day,nan
1473,693,780,2018-07-03,partly-cloudy-day,nan
2448,1096,1352,2018-06-23,cloudy,nan
871,477,394,2018-06-27,partly-cloudy-day,nan
816,816,0,2018-06-15,partly-cloudy-day,nan
15,9,6,2018-07-16,clear-night,nan
1673,691,982,2018-06-20,partly-cloudy-day,nan
2047,916,1131,2018-06-30,clear-day,nan
369,124,245,2018-07-31,partly-cloudy-day,nan
998,394,604,2018-07-19,clear-night,nan
147,72,75,2018-07-02,clear-day,nan
2115,1196,919,2018-07-14,clear-day,nan
2188,1010,1178,2018-07-26,partly-cloudy-day,nan
3,2,1,2018-07-10,clear-night,nan
1235,536,699,2018-07-25,rain,nan
11,6,5,2018-06-29,clear-night,nan
82,34,48,2018-07-17,clear-night,nan
2568,1231,1337,2018-07-22,partly-cloudy-day,nan
346,202,144,2018-07-08,clear-night,nan
2726,2726,0,2018-07-04,partly-cloudy-day,Independence Day
922,316,606,2018-07-26,clear-night,nan
1427,705,722,2018-07-11,partly-cloudy-day,nan
1680,704,976,2018-07-12,partly-cloudy-day,nan
56,16,40,2018-07-31,clear-night,nan
102,59,43,2018-07-22,cloudy,nan
1368,794,574,2018-06-16,clear-day,nan
2461,1047,1414,2018-07-15,clear-day,nan
151,74,77,2018-06-24,cloudy,nan
1175,647,528,2018-07-19,clear-day,nan
13,6,7,2018-07-21,partly-cloudy-night,nan
1428,855,573,2018-06-29,clear-day,nan
48,25,23,2018-07-28,partly-cloudy-night,nan
196,105,91,2018-06-28,clear-night,nan
2430,1197,1233,2018-07-08,clear-day,nan
1374,689,685,2018-07-17,partly-cloudy-day,nan
1365,597,768,2018-07-12,clear-day,nan
323,323,0,2018-07-13,clear-day,nan
1929,893,1036,2018-07-23,partly-cloudy-day,nan
1568,661,907,2018-07-01,clear-day,nan
535,174,361,2018-06-26,clear-day,nan
2918,1403,1515,2018-07-29,partly-cloudy-day,nan
1192,610,582,2018-07-06,partly-cloudy-day,nan
1886,931,955,2018-07-30,partly-cloudy-day,nan
241,103,138,2018-06-30,clear-day,nan
462,190,272,2018-07-18,clear-day,nan
424,227,197,2018-07-07,clear-day,nan
198,93,105,2018-07-24,partly-cloudy-night,nan
2010,1073,937,2018-07-04,partly-cloudy-day,Independence Day
385,120,265,2018-07-09,clear-day,nan
1669,818,851,2018-07-01,clear-day,nan
418,168,250,2018-07-20,clear-day,nan
935,504,431,2018-07-23,partly-cloudy-day,nan
1888,889,999,2018-07-12,partly-cloudy-day,nan
1795,1004,791,2018-07-16,clear-day,nan
353,168,185,2018-06-17,clear-night,Father's Day
1749,849,900,2018-06-14,clear-day,nan
10,6,4,2018-06-13,partly-cloudy-night,nan
270,130,140,2018-06-19,partly-cloudy-day,nan
1077,458,619,2018-06-20,partly-cloudy-day,nan
265,110,155,2018-07-17,cloudy,nan
484,175,309,2018-06-15,clear-day,nan
719,393,326,2018-07-23,partly-cloudy-day,nan
12,11,1,2018-06-15,clear-night,nan
299,114,185,2018-07-24,partly-cloudy-day,nan
412,156,256,2018-06-19,clear-night,nan
67,32,35,2018-06-24,cloudy,nan
282,116,166,2018-07-11,clear-day,nan
705,244,461,2018-06-30,clear-night,nan
1771,1019,752,2018-07-18,clear-day,nan
28,18,10,2018-07-29,clear-night,nan
610,348,262,2018-07-03,clear-day,nan
393,149,244,2018-06-27,cloudy,nan
2710,1333,1377,2018-07-07,clear-day,nan
95,43,52,2018-06-16,clear-day,nan
16,11,5,2018-06-17,clear-night,Father's Day
26,12,14,2018-06-23,cloudy,nan
320,167,153,2018-06-21,partly-cloudy-night,nan
493,188,305,2018-06-25,clear-night,nan
1674,1010,664,2018-07-02,clear-day,nan
274,101,173,2018-07-15,clear-night,nan
1967,891,1076,2018-06-26,clear-day,nan
2038,897,1141,2018-06-17,clear-day,Father's Day
54,23,31,2018-07-02,clear-night,nan
3210,1365,1845,2018-07-21,partly-cloudy-day,nan
199,97,102,2018-06-27,partly-cloudy-day,nan
276,276,0,2018-06-15,partly-cloudy-night,nan
2589,1459,1130,2018-07-21,partly-cloudy-day,nan
1851,793,1058,2018-07-24,partly-cloudy-day,nan
345,148,197,2018-07-20,partly-cloudy-night,nan
1302,591,711,2018-07-31,partly-cloudy-day,nan
664,321,343,2018-06-25,clear-day,nan
219,76,143,2018-07-09,clear-night,nan
6,1,5,2018-07-05,partly-cloudy-night,nan
1236,670,566,2018-06-21,partly-cloudy-day,nan
1623,735,888,2018-07-25,rain,nan
2124,1063,1061,2018-07-14,partly-cloudy-day,nan
1766,761,1005,2018-07-05,partly-cloudy-day,nan
4,0,4,2018-07-09,clear-night,nan
300,300,0,2018-07-13,clear-night,nan
1297,652,645,2018-07-10,clear-day,nan
204,67,137,2018-07-02,clear-night,nan
221,93,128,2018-07-27,rain,nan
1659,957,702,2018-06-21,clear-day,nan
16,11,5,2018-07-07,clear-night,nan
8,4,4,2018-07-03,clear-night,nan
1213,637,576,2018-07-01,clear-day,nan
51,36,15,2018-07-27,clear-night,nan
1750,804,946,2018-06-27,cloudy,nan
77,39,38,2018-07-12,partly-cloudy-night,nan
7,4,3,2018-06-22,partly-cloudy-night,nan
192,89,103,2018-07-19,clear-day,nan
2623,1161,1462,2018-06-16,clear-day,nan
2016,1069,947,2018-07-24,partly-cloudy-day,nan
57,20,37,2018-07-23,cloudy,nan
